,Unnamed: 0,Rank,NOC,Gold,Silver,Bronze,Total,Year,Participants
0,0,1,USA,11,7,2,20,1896,16.0
1,1,2,GRC,10,18,19,47,1896,25.0
2,2,3,DEU,6,5,2,13,1896,12.0
3,3,4,FRA,5,4,2,11,1896,16.0
4,4,5,GBR,2,3,2,7,1896,8.0
5,5,6,HUN,2,1,3,6,1896,5.0
6,6,7,AUT,2,1,2,5,1896,8.0
7,7,8,AUS,2,0,0,2,1896,11.0
8,8,9,DNK,1,2,3,6,1896,5.0
9,9,10,CHE,1,2,0,3,1896,2.0
11,11,1,FRA,27,39,37,103,1900,4.0
12,12,2,USA,19,14,15,48,1900,6.0
13,13,3,GBR,15,7,9,31,1900,3.0
15,15,5,BEL,6,7,4,17,1900,7.0
16,16,6,CHE,6,2,1,9,1900,11.0
17,17,7,DEU,4,3,2,9,1900,5.0
18,18,8,ITA,3,2,0,5,1900,4.0
19,19,9,AUS,2,0,3,5,1900,5.0
20,20,10,DNK,1,3,2,6,1900,2.0
21,21,11,HUN,1,2,2,5,1900,4.0
22,22,12,CUB,1,1,0,2,1900,13.0
23,23,13,CAN,1,0,1,2,1900,4.0
24,24,14,ESP,1,0,0,1,1900,4.0
25,25,14,LUX,1,0,0,1,1900,7.0
26,26,16,AUT,0,3,3,6,1900,8.0
27,27,17,NOR,0,2,3,5,1900,3.0
28,28,17,NLD,0,2,3,5,1900,4.0
29,29,19,IND,0,2,0,2,1900,46.0
31,31,21,SWE,0,0,1,1,1900,9.0
32,32,1,USA,76,78,77,231,1904,9.0
33,33,2,DEU,4,5,6,15,1904,5.0
34,34,3,CAN,4,1,1,6,1904,7.0
35,35,4,CUB,3,0,0,3,1904,12.0
36,36,5,HUN,2,1,1,4,1904,10.0
38,38,7,NOR,2,0,0,2,1904,10.0
39,39,8,AUT,1,1,1,3,1904,9.0
40,40,9,GBR,1,1,0,2,1904,7.0
41,41,10,CHE,1,0,2,3,1904,9.0
42,42,11,GRC,1,0,1,2,1904,7.0
43,43,12,AUS,0,3,1,4,1904,63.0
44,44,13,FRA,0,1,0,1,1904,33.0
45,45,1,GBR,56,51,39,146,1908,45.0
46,46,2,USA,23,12,12,47,1908,36.0
47,47,3,SWE,8,6,11,25,1908,47.0
48,48,4,FRA,5,5,9,19,1908,51.0
49,49,5,DEU,3,5,5,13,1908,71.0
50,50,6,HUN,3,4,2,9,1908,57.0
51,51,7,CAN,3,3,10,16,1908,39.0
52,52,8,NOR,2,3,3,8,1908,74.0
53,53,9,ITA,2,2,0,4,1908,45.0
54,54,10,BEL,1,5,2,8,1908,55.0
55,55,11,AUS,1,2,2,5,1908,3.0
56,56,12,RUS,1,2,0,3,1908,2.0
57,57,13,FIN,1,1,3,5,1908,2.0
58,58,14,ZAF,1,1,0,2,1908,4.0
59,59,15,GRC,0,3,1,4,1908,8.0
60,60,16,DNK,0,2,3,5,1908,8.0
62,62,17,NLD,0,0,2,2,1908,6.0
63,63,19,AUT,0,0,1,1,1908,5.0
64,64,1,USA,26,19,19,64,1912,6.0
65,65,2,SWE,23,25,17,65,1912,4.0
66,66,3,GBR,10,15,16,41,1912,3.0
67,67,4,FIN,9,8,9,26,1912,4.0
68,68,5,FRA,7,4,3,14,1912,17.0
69,69,6,DEU,5,13,7,25,1912,33.0
70,70,7,ZAF,4,2,0,6,1912,33.0
71,71,8,NOR,3,2,5,10,1912,30.0
72,72,9,CAN,3,2,3,8,1912,30.0
73,73,9,HUN,3,2,3,8,1912,30.0
74,74,11,ITA,3,1,2,6,1912,33.0
75,75,12,AUS,2,2,3,7,1912,35.0
76,76,13,BEL,2,1,3,6,1912,26.0
77,77,14,DNK,1,6,5,12,1912,20.0
78,78,15,GRC,1,0,1,2,1912,26.0
79,79,16,RUS,0,2,3,5,1912,17.0
80,80,17,AUT,0,2,2,4,1912,27.0
81,81,18,NLD,0,0,3,3,1912,25.0
82,82,1,USA,41,27,27,95,1920,18.0
83,83,2,SWE,19,20,25,64,1920,19.0
84,84,3,FIN,15,10,9,34,1920,4.0
85,85,4,GBR,14,15,13,42,1920,5.0
86,86,5,BEL,14,11,11,36,1920,5.0
87,87,6,NOR,13,9,9,31,1920,4.0
88,88,7,ITA,13,5,5,23,1920,9.0
89,89,8,FRA,9,19,13,41,1920,6.0
90,90,9,NLD,4,2,5,11,1920,5.0
91,91,10,DNK,3,9,1,13,1920,48.0
92,92,11,ZAF,3,4,3,10,1920,38.0
93,93,12,CAN,3,3,3,9,1920,1.0
94,94,13,CHE,2,2,7,11,1920,1.0
95,95,14,EST,1,2,0,3,1920,1.0
96,96,15,BRA,1,1,1,3,1920,109.0
97,97,16,AUS,0,2,1,3,1920,98.0
98,98,17,JPN,0,2,0,2,1920,47.0
99,99,17,ESP,0,2,0,2,1920,68.0
100,100,19,GRC,0,1,0,1,1920,295.0
101,101,19,LUX,0,1,0,1,1920,174.0
103,103,22,NZL,0,0,1,1,1920,116.0
104,104,1,USA,45,27,27,99,1924,148.0
105,105,2,FIN,14,13,10,37,1924,132.0
106,106,3,FRA,13,15,10,38,1924,123.0
107,107,4,GBR,9,13,12,34,1924,106.0
108,108,5,ITA,8,3,5,16,1924,115.0
109,109,6,CHE,7,8,10,25,1924,134.0
110,110,7,NOR,5,2,3,10,1924,111.0
111,111,8,SWE,4,13,12,29,1924,221.0
112,112,9,NLD,4,1,5,10,1924,165.0
113,113,10,BEL,3,7,3,13,1924,179.0
114,114,11,AUS,3,1,2,6,1924,145.0
115,115,12,DNK,2,5,2,9,1924,148.0
116,116,13,HUN,2,3,4,9,1924,232.0
117,117,14,YUG,2,0,0,2,1924,208.0
119,119,16,ARG,1,3,2,6,1924,38.0
120,120,17,EST,1,1,4,6,1924,26.0
121,121,18,ZAF,1,1,1,3,1924,19.0
122,122,19,URY,1,0,0,1,1924,26.0
123,123,20,AUT,0,3,1,4,1924,31.0
124,124,20,CAN,0,3,1,4,1924,34.0
125,125,22,POL,0,1,1,2,1924,19.0
126,126,23,HTI,0,0,1,1,1924,17.0
127,127,23,JPN,0,0,1,1,1924,12.0
128,128,23,NZL,0,0,1,1,1924,5.0
129,129,23,PRT,0,0,1,1,1924,3.0
130,130,23,ROU,0,0,1,1,1924,5.0
131,131,1,USA,22,18,16,56,1928,4.0
132,132,2,DEU,10,7,14,31,1928,2.0
133,133,3,FIN,8,8,9,25,1928,4.0
134,134,4,SWE,7,6,12,25,1928,7.0
135,135,5,ITA,7,5,7,19,1928,4.0
136,136,6,CHE,7,4,4,15,1928,7.0
137,137,7,FRA,6,10,5,21,1928,6.0
138,138,8,NLD,6,9,4,19,1928,3.0
139,139,9,HUN,4,5,0,9,1928,7.0
140,140,10,CAN,4,4,7,15,1928,4.0
141,141,11,GBR,3,10,7,20,1928,3.0
142,142,12,ARG,3,3,1,7,1928,4.0
143,143,13,DNK,3,1,2,6,1928,4.0
145,145,15,JPN,2,2,1,5,1928,6.0
146,146,16,EST,2,1,2,5,1928,2.0
147,147,17,EGY,2,1,1,4,1928,5.0
148,148,18,AUT,2,0,1,3,1928,6.0
149,149,19,AUS,1,2,1,4,1928,6.0
150,150,19,NOR,1,2,1,4,1928,10.0
151,151,21,POL,1,1,3,5,1928,29.0
152,152,21,YUG,1,1,3,5,1928,60.0
153,153,23,ZAF,1,0,2,3,1928,29.0
154,154,24,IND,1,0,0,1,1928,20.0
155,155,24,IRL,1,0,0,1,1928,39.0
156,156,24,NZL,1,0,0,1,1928,103.0
157,157,24,ESP,1,0,0,1,1928,140.0
158,158,24,URY,1,0,0,1,1928,412.0
159,159,29,BEL,0,1,2,3,1928,280.0
160,160,30,CHL,0,1,0,1,1928,392.0
161,161,30,HTI,0,1,0,1,1928,224.0
162,162,32,PHL,0,0,1,1,1928,266.0
163,163,32,PRT,0,0,1,1,1928,274.0
164,164,1,USA,44,36,30,110,1932,190.0
165,165,2,ITA,12,12,12,36,1932,337.0
166,166,3,FRA,11,5,4,20,1932,339.0
167,167,4,SWE,10,5,9,24,1932,390.0
168,168,5,JPN,7,7,4,18,1932,550.0
169,169,6,HUN,6,5,5,16,1932,788.0
170,170,7,DEU,5,12,7,24,1932,601.0
171,171,8,FIN,5,8,12,25,1932,570.0
172,172,9,GBR,5,7,5,17,1932,514.0
173,173,10,POL,3,2,4,9,1932,518.0
174,174,11,AUS,3,1,1,5,1932,638.0
175,175,12,ARG,3,1,0,4,1932,649.0
176,176,13,CAN,2,5,9,16,1932,8.0
177,177,14,NLD,2,5,1,8,1932,26.0
178,178,15,ZAF,2,0,3,5,1932,7.0
179,179,16,IRL,2,0,0,2,1932,100.0
181,181,18,AUT,1,1,3,5,1932,132.0
182,182,19,IND,1,0,0,1,1932,56.0
183,183,20,DNK,0,5,3,8,1932,113.0
184,184,21,MEX,0,2,0,2,1932,33.0
185,185,22,LVA,0,1,0,1,1932,363.0
186,186,22,NZL,0,1,0,1,1932,239.0
187,187,22,CHE,0,1,0,1,1932,238.0
188,188,25,PHL,0,0,3,3,1932,57.0
189,189,26,BEL,0,0,1,1,1932,198.0
190,190,26,ESP,0,0,1,1,1932,82.0
191,191,26,URY,0,0,1,1,1932,59.0
192,192,1,DEU,38,31,32,101,1936,143.0
193,193,2,USA,24,21,12,57,1936,73.0
194,194,3,HUN,10,1,5,16,1936,92.0
195,195,4,ITA,9,13,5,27,1936,130.0
196,196,5,FIN,8,6,6,20,1936,96.0
197,197,6,FRA,7,6,6,19,1936,127.0
198,198,7,SWE,6,5,10,21,1936,92.0
199,199,8,JPN,6,4,10,20,1936,114.0
200,200,9,NLD,6,4,7,17,1936,92.0
201,201,10,AUT,5,7,5,17,1936,93.0
202,202,11,CHE,4,9,5,18,1936,90.0
203,203,12,GBR,4,7,3,14,1936,85.0
205,205,14,ARG,2,2,3,7,1936,121.0
206,206,14,EST,2,2,3,7,1936,24.0
207,207,16,EGY,2,1,2,5,1936,32.0
208,208,17,CAN,1,3,5,9,1936,37.0
209,209,18,NOR,1,3,2,6,1936,44.0
210,210,19,TUR,1,0,1,2,1936,59.0
211,211,20,IND,1,0,0,1,1936,69.0
212,212,20,NZL,1,0,0,1,1936,55.0
213,213,22,POL,0,4,5,9,1936,49.0
214,214,23,DNK,0,2,3,5,1936,7.0
215,215,24,LVA,0,1,1,2,1936,5.0
216,216,25,ROU,0,1,0,1,1936,14.0
217,217,25,ZAF,0,1,0,1,1936,12.0
218,218,25,YUG,0,1,0,1,1936,22.0
219,219,28,BEL,0,0,3,3,1936,25.0
220,220,28,MEX,0,0,3,3,1936,19.0
221,221,30,AUS,0,0,1,1,1936,31.0
222,222,30,PHL,0,0,1,1,1936,18.0
223,223,30,PRT,0,0,1,1,1936,18.0
224,224,1,USA,38,27,19,84,1948,36.0
225,225,2,SWE,16,11,17,44,1948,39.0
226,226,3,FRA,10,6,13,29,1948,28.0
227,227,4,HUN,10,5,12,27,1948,33.0
228,228,5,ITA,8,11,8,27,1948,29.0
229,229,6,FIN,8,7,5,20,1948,38.0
230,230,7,TUR,6,4,2,12,1948,22.0
232,232,9,CHE,5,10,5,20,1948,2.0
233,233,10,DNK,5,7,8,20,1948,11.0
234,234,11,NLD,5,2,9,16,1948,9.0
235,235,12,GBR,3,14,6,23,1948,4.0
236,236,13,ARG,3,3,1,7,1948,6.0
237,237,14,AUS,2,6,5,13,1948,4.0
238,238,15,BEL,2,2,3,7,1948,5.0
239,239,16,EGY,2,2,1,5,1948,7.0
240,240,17,MEX,2,1,2,5,1948,7.0
241,241,18,ZAF,2,1,1,4,1948,8.0
242,242,19,NOR,1,3,3,7,1948,5.0
243,243,20,JAM,1,2,0,3,1948,13.0
244,244,21,AUT,1,0,3,4,1948,20.0
245,245,22,IND,1,0,0,1,1948,17.0
246,246,22,PER,1,0,0,1,1948,25.0
247,247,24,YUG,0,2,0,2,1948,26.0
248,248,25,CAN,0,1,2,3,1948,22.0
249,249,26,PRT,0,1,1,2,1948,22.0
250,250,26,URY,0,1,1,2,1948,28.0
252,252,28,CUB,0,1,0,1,1948,10.0
253,253,28,ESP,0,1,0,1,1948,8.0
254,254,28,TTO,0,1,0,1,1948,13.0
255,255,32,PAN,0,0,2,2,1948,9.0
256,256,32,KOR,0,0,2,2,1948,4.0
257,257,34,BRA,0,0,1,1,1948,7.0
258,258,34,IRN,0,0,1,1,1948,6.0
259,259,34,POL,0,0,1,1,1948,7.0
260,260,34,PRI,0,0,1,1,1948,3.0
261,261,1,USA,40,19,17,76,1952,6.0
263,263,3,HUN,16,10,16,42,1952,7.0
264,264,4,SWE,12,13,10,35,1952,8.0
265,265,5,ITA,8,9,4,21,1952,100.0
267,267,7,FRA,6,6,6,18,1952,99.0
268,268,8,FIN,6,3,13,22,1952,72.0
269,269,9,AUS,6,2,3,11,1952,518.0
270,270,10,NOR,3,2,0,5,1952,234.0
271,271,11,CHE,2,6,6,14,1952,260.0
272,272,12,ZAF,2,4,4,10,1952,69.0
273,273,13,JAM,2,3,0,5,1952,205.0
274,274,14,BEL,2,2,0,4,1952,182.0
275,275,15,DNK,2,1,3,6,1952,184.0
276,276,16,TUR,2,0,1,3,1952,82.0
277,277,17,JPN,1,6,2,9,1952,150.0
278,278,18,GBR,1,2,8,11,1952,74.0
279,279,19,ARG,1,2,2,5,1952,106.0
280,280,20,POL,1,2,1,4,1952,106.0
281,281,21,CAN,1,2,0,3,1952,149.0
282,282,21,YUG,1,2,0,3,1952,84.0
283,283,23,ROU,1,1,2,4,1952,86.0
284,284,24,BRA,1,0,2,3,1952,85.0
285,285,24,NZL,1,0,2,3,1952,103.0
286,286,26,IND,1,0,1,2,1952,81.0
287,287,27,LUX,1,0,0,1,1952,94.0
288,288,28,DEU,0,7,17,24,1952,70.0
289,289,29,NLD,0,5,0,5,1952,112.0
290,290,30,IRN,0,3,4,7,1952,142.0
291,291,31,CHL,0,2,0,2,1952,138.0
292,292,32,AUT,0,1,1,2,1952,185.0
293,293,32,LBN,0,1,1,2,1952,240.0
294,294,34,IRL,0,1,0,1,1952,3.0
295,295,34,MEX,0,1,0,1,1952,17.0
296,296,34,ESP,0,1,0,1,1952,3.0
297,297,37,KOR,0,0,2,2,1952,10.0
298,298,37,TTO,0,0,2,2,1952,7.0
299,299,37,URY,0,0,2,2,1952,7.0
300,300,40,BGR,0,0,1,1,1952,4.0
301,301,40,EGY,0,0,1,1,1952,4.0
302,302,40,PRT,0,0,1,1,1952,5.0
303,303,40,VEN,0,0,1,1,1952,5.0
305,305,2,USA,32,25,17,74,1956,7.0
306,306,3,AUS,13,8,14,35,1956,5.0
307,307,4,HUN,9,10,7,26,1956,9.0
308,308,5,ITA,8,8,9,25,1956,28.0
309,309,6,SWE,8,5,6,19,1956,12.0
310,310,7,DEU,6,13,7,26,1956,3.0
311,311,8,GBR,6,7,11,24,1956,9.0
312,312,9,ROU,5,3,5,13,1956,4.0
313,313,10,JPN,4,10,5,19,1956,6.0
314,314,11,FRA,4,4,6,14,1956,9.0
315,315,12,TUR,3,2,2,7,1956,20.0
316,316,13,FIN,3,1,11,15,1956,13.0
317,317,14,IRN,2,2,1,5,1956,14.0
318,318,15,CAN,2,1,3,6,1956,29.0
319,319,16,NZL,2,0,0,2,1956,10.0
320,320,17,POL,1,4,4,9,1956,7.0
322,322,19,BGR,1,3,1,5,1956,6.0
323,323,20,DNK,1,2,1,4,1956,8.0
324,324,21,IRL,1,1,3,5,1956,8.0
325,325,22,NOR,1,0,2,3,1956,2.0
326,326,23,MEX,1,0,1,2,1956,8.0
327,327,24,BRA,1,0,0,1,1956,6.0
328,328,24,IND,1,0,0,1,1956,6.0
329,329,26,YUG,0,3,0,3,1956,12.0
330,330,27,CHL,0,2,2,4,1956,2.0
331,331,28,BEL,0,2,0,2,1956,2.0
332,332,29,ARG,0,1,1,2,1956,2.0
333,333,29,KOR,0,1,1,2,1956,2.0
334,334,31,ISL,0,1,0,1,1956,2.0
335,335,31,PAK,0,1,0,1,1956,2.0
336,336,33,ZAF,0,0,4,4,1956,4.0
337,337,34,AUT,0,0,2,2,1956,3.0
338,338,35,BHS,0,0,1,1,1956,13.0
339,339,35,GRC,0,0,1,1,1956,12.0
340,340,35,CHE,0,0,1,1,1956,11.0
341,341,35,URY,0,0,1,1,1956,11.0
343,343,2,USA,34,21,16,71,1960,8.0
344,344,3,ITA,13,10,13,36,1960,11.0
345,345,4,DEU,12,19,11,42,1960,8.0
346,346,5,AUS,8,8,6,22,1960,6.0
347,347,6,TUR,7,2,0,9,1960,7.0
348,348,7,HUN,6,8,7,21,1960,2.0
349,349,8,JPN,4,7,7,18,1960,4.0
350,350,9,POL,4,6,11,21,1960,13.0
352,352,11,ROU,3,1,6,10,1960,18.0
353,353,12,GBR,2,6,12,20,1960,5.0
354,354,13,DNK,2,3,1,6,1960,2.0
355,355,14,NZL,2,0,1,3,1960,2.0
356,356,15,BGR,1,3,3,7,1960,4.0
357,357,16,SWE,1,2,3,6,1960,3.0
358,358,17,FIN,1,1,3,5,1960,3.0
359,359,18,AUT,1,1,0,2,1960,4.0
360,360,18,YUG,1,1,0,2,1960,1.0
361,361,20,PAK,1,0,1,2,1960,259.0
362,362,21,ETH,1,0,0,1,1960,231.0
363,363,21,GRC,1,0,0,1,1960,192.0
364,364,21,NOR,1,0,0,1,1960,237.0
365,365,24,CHE,0,3,3,6,1960,185.0
366,366,25,FRA,0,2,3,5,1960,142.0
367,367,26,BEL,0,2,2,4,1960,137.0
368,368,27,IRN,0,1,3,4,1960,9.0
369,369,28,NLD,0,1,2,3,1960,29.0
370,370,28,ZAF,0,1,2,3,1960,41.0
371,371,30,ARG,0,1,1,2,1960,74.0
372,372,30,EGY,0,1,1,2,1960,2.0
373,373,32,CAN,0,1,0,1,1960,1.0
374,374,32,TWN,0,1,0,1,1960,4.0
375,375,32,GHA,0,1,0,1,1960,14.0
376,376,32,IND,0,1,0,1,1960,5.0
377,377,32,MAR,0,1,0,1,1960,13.0
378,378,32,PRT,0,1,0,1,1960,12.0
379,379,32,SGP,0,1,0,1,1960,21.0
380,380,39,BRA,0,0,2,2,1960,9.0
381,381,39,IND,0,0,2,2,1960,5.0
382,382,41,IRQ,0,0,1,1,1960,11.0
383,383,41,MEX,0,0,1,1,1960,7.0
384,384,41,ESP,0,0,1,1,1960,5.0
385,385,41,VEN,0,0,1,1,1960,12.0
386,386,1,USA,36,26,28,90,1964,5.0
388,388,3,JPN,16,5,8,29,1964,8.0
389,389,4,DEU,10,22,18,50,1964,8.0
390,390,5,ITA,10,10,7,27,1964,11.0
391,391,6,HUN,10,7,5,22,1964,6.0
392,392,7,POL,7,6,10,23,1964,7.0
393,393,8,AUS,6,2,10,18,1964,9.0
395,395,10,GBR,4,12,2,18,1964,11.0
396,396,11,BGR,3,5,2,10,1964,4.0
397,397,12,FIN,3,0,2,5,1964,14.0
398,398,12,NZL,3,0,2,5,1964,16.0
399,399,14,ROU,2,4,6,12,1964,19.0
400,400,15,NLD,2,4,4,10,1964,3.0
401,401,16,TUR,2,3,1,6,1964,38.0
402,402,17,SWE,2,2,4,8,1964,18.0
403,403,18,DNK,2,1,3,6,1964,67.0
404,404,19,YUG,2,1,2,5,1964,94.0
405,405,20,BEL,2,0,1,3,1964,105.0
406,406,21,FRA,1,8,6,15,1964,119.0
407,407,22,CAN,1,2,1,4,1964,63.0
408,408,22,CHE,1,2,1,4,1964,86.0
409,409,24,BHS,1,0,0,1,1964,65.0
410,410,24,ETH,1,0,0,1,1964,89.0
411,411,24,IND,1,0,0,1,1964,104.0
412,412,27,KOR,0,2,1,3,1964,89.0
413,413,28,TTO,0,1,2,3,1964,149.0
414,414,29,TUN,0,1,1,2,1964,197.0
415,415,30,ARG,0,1,0,1,1964,233.0
416,416,30,CUB,0,1,0,1,1964,233.0
417,417,30,PAK,0,1,0,1,1964,251.0
418,418,30,PHL,0,1,0,1,1964,236.0
419,419,34,IRN,0,0,2,2,1964,318.0
420,420,35,BRA,0,0,1,1,1964,338.0
421,421,35,GHA,0,0,1,1,1964,306.0
422,422,35,IRL,0,0,1,1,1964,583.0
423,423,35,KEN,0,0,1,1,1964,416.0
424,424,35,MEX,0,0,1,1,1964,401.0
425,425,35,NGA,0,0,1,1,1964,14.0
426,426,35,URY,0,0,1,1,1964,16.0
427,427,1,USA,45,28,34,107,1968,15.0
429,429,3,JPN,11,7,7,25,1968,4.0
430,430,4,HUN,10,10,12,32,1968,10.0
431,431,5,DDR,9,9,7,25,1968,15.0
432,432,6,FRA,7,3,5,15,1968,14.0
434,434,8,DEU,5,11,10,26,1968,33.0
435,435,9,AUS,5,7,5,17,1968,15.0
436,436,10,GBR,5,5,3,13,1968,1.0
437,437,11,POL,5,2,11,18,1968,2.0
438,438,12,ROU,4,6,5,15,1968,1.0
439,439,13,ITA,3,4,9,16,1968,3.0
440,440,14,KEN,3,4,2,9,1968,3.0
441,441,15,MEX,3,3,3,9,1968,2.0
442,442,16,YUG,3,3,2,8,1968,3.0
443,443,17,NLD,3,3,1,7,1968,31.0
444,444,18,BGR,2,4,3,9,1968,10.0
445,445,19,IRN,2,1,2,5,1968,2.0
446,446,20,SWE,2,1,1,4,1968,85.0
447,447,21,TUR,2,0,0,2,1968,179.0
448,448,22,DNK,1,4,3,8,1968,82.0
449,449,23,CAN,1,3,1,5,1968,183.0
450,450,24,FIN,1,2,1,4,1968,116.0
451,451,25,ETH,1,1,0,2,1968,189.0
452,452,25,NOR,1,1,0,2,1968,226.0
453,453,27,NZL,1,0,2,3,1968,254.0
454,454,28,TUN,1,0,1,2,1968,397.0
455,455,29,PAK,1,0,0,1,1968,281.0
456,456,29,VEN,1,0,0,1,1968,236.0
457,457,31,CUB,0,4,0,4,1968,181.0
458,458,32,AUT,0,2,2,4,1968,150.0
459,459,33,CHE,0,1,4,5,1968,119.0
460,460,34,MNG,0,1,3,4,1968,87.0
461,461,35,BRA,0,1,2,3,1968,75.0
462,462,36,BEL,0,1,1,2,1968,58.0
463,463,36,KOR,0,1,1,2,1968,56.0
464,464,36,UGA,0,1,1,2,1968,61.0
465,465,39,CMR,0,1,0,1,1968,1.0
466,466,39,JAM,0,1,0,1,1968,9.0
467,467,41,ARG,0,0,2,2,1968,4.0
468,468,42,GRC,0,0,1,1,1968,5.0
469,469,42,IND,0,0,1,1,1968,4.0
470,470,42,TWN,0,0,1,1,1968,5.0
472,472,2,USA,33,31,30,94,1972,5.0
473,473,3,DDR,20,23,23,66,1972,5.0
474,474,4,DEU,13,11,16,40,1972,8.0
475,475,5,JPN,13,8,8,29,1972,8.0
476,476,6,AUS,8,7,2,17,1972,1.0
477,477,7,POL,7,5,9,21,1972,3.0
478,478,8,HUN,6,13,16,35,1972,15.0
479,479,9,BGR,6,10,5,21,1972,21.0
480,480,10,ITA,5,3,10,18,1972,5.0
481,481,11,SWE,4,6,6,16,1972,3.0
482,482,12,GBR,4,5,9,18,1972,4.0
483,483,13,ROU,3,6,7,16,1972,3.0
484,484,14,CUB,3,1,4,8,1972,6.0
485,485,14,FIN,3,1,4,8,1972,6.0
486,486,16,NLD,3,1,1,5,1972,2.0
487,487,17,FRA,2,4,7,13,1972,4.0
489,489,19,KEN,2,3,4,9,1972,15.0
490,490,20,YUG,2,1,2,5,1972,17.0
491,491,21,NOR,2,1,1,4,1972,5.0
492,492,22,PRK,1,1,3,5,1972,4.0
493,493,23,NZL,1,1,1,3,1972,4.0
494,494,24,UGA,1,1,0,2,1972,4.0
495,495,25,DNK,1,0,0,1,1972,6.0
496,496,26,CHE,0,3,0,3,1972,6.0
497,497,27,CAN,0,2,3,5,1972,3.0
498,498,28,IRN,0,2,1,3,1972,3.0
499,499,29,BEL,0,2,0,2,1972,7.0
500,500,29,GRC,0,2,0,2,1972,61.0
501,501,31,AUT,0,1,2,3,1972,4.0
502,502,31,COL,0,1,2,3,1972,148.0
503,503,33,ARG,0,1,0,1,1972,60.0
504,504,33,LBN,0,1,0,1,1972,85.0
505,505,33,MEX,0,1,0,1,1972,83.0
506,506,33,MNG,0,1,0,1,1972,113.0
507,507,33,PAK,0,1,0,1,1972,191.0
508,508,33,KOR,0,1,0,1,1972,167.0
509,509,33,TUN,0,1,0,1,1972,188.0
510,510,33,TUR,0,1,0,1,1972,154.0
511,511,41,BRA,0,0,2,2,1972,150.0
512,512,41,ETH,0,0,2,2,1972,140.0
513,513,43,GHA,0,0,1,1,1972,194.0
514,514,43,IND,0,0,1,1,1972,291.0
515,515,43,JAM,0,0,1,1,1972,344.0
516,516,43,NER,0,0,1,1,1972,531.0
517,517,43,NGA,0,0,1,1,1972,572.0
518,518,43,ESP,0,0,1,1,1972,503.0
520,520,2,DDR,40,25,25,90,1976,408.0
521,521,3,USA,34,35,25,94,1976,422.0
522,522,4,DEU,10,12,17,39,1976,391.0
523,523,5,JPN,9,6,10,25,1976,449.0
524,524,6,POL,7,6,13,26,1976,354.0
525,525,7,BGR,6,9,7,22,1976,405.0
526,526,8,CUB,6,4,3,13,1976,509.0
527,527,9,ROU,4,9,14,27,1976,538.0
528,528,10,HUN,4,5,13,22,1976,2.0
529,529,11,FIN,4,2,0,6,1976,14.0
530,530,12,SWE,4,1,0,5,1976,12.0
531,531,13,GBR,3,5,5,13,1976,13.0
532,532,14,ITA,2,7,4,13,1976,9.0
533,533,15,FRA,2,3,4,9,1976,4.0
534,534,16,YUG,2,3,3,8,1976,8.0
536,536,18,NZL,2,1,1,4,1976,7.0
537,537,19,KOR,1,1,4,6,1976,5.0
538,538,20,CHE,1,1,2,4,1976,9.0
539,539,21,JAM,1,1,0,2,1976,5.0
540,540,21,PRK,1,1,0,2,1976,2.0
541,541,21,NOR,1,1,0,2,1976,8.0
542,542,24,DNK,1,0,2,3,1976,25.0
543,543,25,MEX,1,0,1,2,1976,13.0
544,544,26,TTO,1,0,0,1,1976,10.0
545,545,27,CAN,0,5,6,11,1976,10.0
546,546,28,BEL,0,3,3,6,1976,5.0
547,547,29,NLD,0,2,3,5,1976,5.0
548,548,30,PRT,0,2,0,2,1976,5.0
549,549,30,ESP,0,2,0,2,1976,5.0
550,550,32,AUS,0,1,4,5,1976,7.0
551,551,33,IRN,0,1,1,2,1976,10.0
552,552,34,MNG,0,1,0,1,1976,3.0
553,553,34,VEN,0,1,0,1,1976,4.0
554,554,36,BRA,0,0,2,2,1976,2.0
555,555,37,AUT,0,0,1,1,1976,4.0
556,556,37,BMU,0,0,1,1,1976,5.0
557,557,37,PAK,0,0,1,1,1976,3.0
558,558,37,PRI,0,0,1,1,1976,6.0
559,559,37,THA,0,0,1,1,1976,7.0
561,561,2,DDR,47,37,42,126,1980,3.0
562,562,3,BGR,8,16,17,41,1980,1.0
563,563,4,CUB,8,7,5,20,1980,2.0
564,564,5,ITA,8,3,4,15,1980,2.0
565,565,6,HUN,7,10,15,32,1980,2.0
566,566,7,ROU,6,6,13,25,1980,3.0
567,567,8,FRA,6,5,3,14,1980,3.0
568,568,9,GBR,5,7,9,21,1980,28.0
569,569,10,POL,3,14,15,32,1980,2.0
570,570,11,SWE,3,3,6,12,1980,18.0
571,571,12,FIN,3,1,4,8,1980,46.0
573,573,14,YUG,2,3,4,9,1980,72.0
574,574,15,AUS,2,2,5,9,1980,82.0
575,575,16,DNK,2,1,2,5,1980,43.0
576,576,17,BRA,2,0,2,4,1980,9.0
577,577,17,ETH,2,0,2,4,1980,16.0
578,578,19,CHE,2,0,0,2,1980,25.0
579,579,20,ESP,1,3,2,6,1980,13.0
580,580,21,AUT,1,2,1,4,1980,9.0
581,581,22,GRC,1,0,2,3,1980,64.0
582,582,23,BEL,1,0,0,1,1980,23.0
583,583,23,IND,1,0,0,1,1980,15.0
584,584,23,ZWE,1,0,0,1,1980,24.0
585,585,26,PRK,0,3,2,5,1980,58.0
586,586,27,MNG,0,2,2,4,1980,29.0
587,587,28,TZA,0,2,0,2,1980,29.0
588,588,29,MEX,0,1,3,4,1980,44.0
589,589,30,NLD,0,1,2,3,1980,47.0
590,590,31,IRL,0,1,1,2,1980,63.0
591,591,32,UGA,0,1,0,1,1980,52.0
592,592,32,VEN,0,1,0,1,1980,2.0
593,593,34,JAM,0,0,3,3,1980,65.0
594,594,35,GUY,0,0,1,1,1980,33.0
595,595,35,LBN,0,0,1,1,1980,1.0
596,596,1,USA,83,61,30,174,1984,323.0
597,597,2,ROU,20,16,17,53,1984,427.0
598,598,3,DEU,17,19,23,59,1984,394.0
599,599,4,CHN,15,8,9,32,1984,438.0
600,600,5,ITA,14,6,12,32,1984,414.0
601,601,6,CAN,10,18,16,44,1984,518.0
602,602,7,JPN,10,8,14,32,1984,730.0
603,603,8,NZL,8,1,2,11,1984,479.0
604,604,9,YUG,7,4,7,18,1984,499.0
605,605,10,KOR,6,6,7,19,1984,574.0
606,606,11,GBR,5,11,21,37,1984,587.0
607,607,12,FRA,5,7,16,28,1984,10.0
608,608,13,NLD,5,2,6,13,1984,11.0
609,609,14,AUS,4,8,12,24,1984,13.0
610,610,15,FIN,4,2,6,12,1984,11.0
611,611,16,SWE,2,11,6,19,1984,18.0
612,612,17,MEX,2,3,1,6,1984,29.0
613,613,18,MAR,2,0,0,2,1984,18.0
614,614,19,BRA,1,5,2,8,1984,13.0
615,615,20,ESP,1,2,2,5,1984,18.0
616,616,21,BEL,1,1,2,4,1984,5.0
617,617,22,AUT,1,1,1,3,1984,22.0
618,618,23,KEN,1,0,2,3,1984,10.0
619,619,23,PRT,1,0,2,3,1984,15.0
620,620,25,PAK,1,0,0,1,1984,32.0
621,621,26,CHE,0,4,4,8,1984,18.0
622,622,27,DNK,0,3,3,6,1984,2.0
623,623,28,JAM,0,1,2,3,1984,5.0
624,624,28,NOR,0,1,2,3,1984,18.0
625,625,30,GRC,0,1,1,2,1984,4.0
626,626,30,NGA,0,1,1,2,1984,29.0
627,627,30,PRI,0,1,1,2,1984,56.0
628,628,33,COL,0,1,0,1,1984,21.0
629,629,33,EGY,0,1,0,1,1984,12.0
630,630,33,IRL,0,1,0,1,1984,19.0
631,631,33,CIV,0,1,0,1,1984,39.0
632,632,33,PER,0,1,0,1,1984,19.0
633,633,33,SYR,0,1,0,1,1984,32.0
634,634,33,THA,0,1,0,1,1984,32.0
635,635,40,TUR,0,0,3,3,1984,22.0
636,636,40,VEN,0,0,3,3,1984,12.0
637,637,42,DZA,0,0,2,2,1984,6.0
638,638,43,CMR,0,0,1,1,1984,8.0
639,639,43,TWN,0,0,1,1,1984,9.0
640,640,43,DOM,0,0,1,1,1984,21.0
641,641,43,ISL,0,0,1,1,1984,19.0
642,642,43,ZMB,0,0,1,1,1984,14.0
644,644,2,DDR,37,35,30,102,1988,6.0
645,645,3,USA,36,31,27,94,1988,5.0
646,646,4,KOR,12,10,11,33,1988,4.0
647,647,5,DEU,11,14,15,40,1988,4.0
648,648,6,HUN,11,6,6,23,1988,7.0
649,649,7,BGR,10,12,13,35,1988,6.0
650,650,8,ROU,7,11,6,24,1988,8.0
651,651,9,FRA,6,4,6,16,1988,2.0
652,652,10,ITA,6,4,4,14,1988,3.0
653,653,11,CHN,5,11,12,28,1988,2.0
654,654,12,GBR,5,10,9,24,1988,3.0
655,655,13,KEN,5,2,2,9,1988,4.0
656,656,14,JPN,4,3,7,14,1988,9.0
657,657,15,AUS,3,6,5,14,1988,9.0
658,658,16,YUG,3,4,5,12,1988,9.0
660,660,18,NZL,3,2,8,13,1988,1.0
661,661,19,CAN,3,2,5,10,1988,2.0
662,662,20,POL,2,5,9,16,1988,6.0
663,663,21,NOR,2,3,0,5,1988,11.0
664,664,22,NLD,2,2,5,9,1988,47.0
665,665,23,DNK,2,1,1,4,1988,23.0
666,666,24,BRA,1,2,3,6,1988,40.0
667,667,25,FIN,1,1,2,4,1988,70.0
668,668,25,ESP,1,1,2,4,1988,75.0
669,669,27,TUR,1,1,0,2,1988,44.0
670,670,28,MAR,1,0,2,3,1988,28.0
671,671,29,AUT,1,0,0,1,1988,48.0
672,672,29,PRT,1,0,0,1,1988,57.0
673,673,29,SUR,1,0,0,1,1988,61.0
674,674,32,SWE,0,4,7,11,1988,62.0
675,675,33,CHE,0,2,2,4,1988,54.0
676,676,34,JAM,0,2,0,2,1988,71.0
677,677,35,ARG,0,1,1,2,1988,90.0
678,678,36,CHL,0,1,0,1,1988,120.0
679,679,36,CRI,0,1,0,1,1988,157.0
680,680,36,IDN,0,1,0,1,1988,77.0
681,681,36,IRN,0,1,0,1,1988,105.0
683,683,36,PER,0,1,0,1,1988,2.0
684,684,36,SEN,0,1,0,1,1988,3.0
685,685,36,VGB,0,1,0,1,1988,3.0
686,686,44,BEL,0,0,2,2,1988,3.0
687,687,44,MEX,0,0,2,2,1988,4.0
688,688,46,COL,0,0,1,1,1988,3.0
689,689,46,DJI,0,0,1,1,1988,5.0
690,690,46,GRC,0,0,1,1,1988,3.0
691,691,46,MNG,0,0,1,1,1988,2.0
692,692,46,PAK,0,0,1,1,1988,3.0
693,693,46,PHL,0,0,1,1,1988,2.0
694,694,46,THA,0,0,1,1,1988,3.0
695,695,2,USA,37,34,37,108,1992,5.0
696,696,3,DEU,33,21,28,82,1992,6.0
697,697,4,CHN,16,22,16,54,1992,7.0
698,698,5,CUB,14,6,11,31,1992,1.0
699,699,6,ESP,13,7,2,22,1992,2.0
700,700,7,KOR,12,5,12,29,1992,27.0
701,701,8,HUN,11,12,7,30,1992,4.0
702,702,9,FRA,8,5,16,29,1992,10.0
703,703,10,AUS,7,9,11,27,1992,37.0
704,704,11,CAN,7,4,7,18,1992,32.0
705,705,12,ITA,6,5,8,19,1992,33.0
706,706,13,GBR,5,3,12,20,1992,20.0
707,707,14,ROU,4,6,8,18,1992,13.0
709,709,16,PRK,4,0,5,9,1992,21.0
710,710,17,JPN,3,8,11,22,1992,8.0
711,711,18,BGR,3,7,6,16,1992,11.0
712,712,19,POL,3,6,10,19,1992,12.0
713,713,20,NLD,2,6,7,15,1992,18.0
714,714,21,KEN,2,4,2,8,1992,6.0
715,715,22,NOR,2,4,1,7,1992,46.0
716,716,23,TUR,2,2,2,6,1992,117.0
717,717,24,IDN,2,2,1,5,1992,108.0
718,718,25,BRA,2,1,0,3,1992,100.0
719,719,26,GRC,2,0,0,2,1992,125.0
720,720,27,SWE,1,7,4,12,1992,118.0
721,721,28,NZL,1,4,5,10,1992,93.0
722,722,29,FIN,1,2,2,5,1992,74.0
723,723,30,DNK,1,1,4,6,1992,85.0
724,724,31,MAR,1,1,1,3,1992,11.0
725,725,32,IRL,1,1,0,2,1992,2.0
726,726,33,ETH,1,0,2,3,1992,6.0
727,727,34,DZA,1,0,1,2,1992,13.0
728,728,34,EST,1,0,1,2,1992,1.0
729,729,34,LTU,1,0,1,2,1992,3.0
730,730,37,CHE,1,0,0,1,1992,112.0
731,731,38,JAM,0,3,1,4,1992,57.0
732,732,38,NGA,0,3,1,4,1992,24.0
733,733,40,LVA,0,2,1,3,1992,21.0
734,734,41,AUT,0,2,0,2,1992,76.0
735,735,41,NAM,0,2,0,2,1992,227.0
736,736,41,ZAF,0,2,0,2,1992,201.0
737,737,44,BEL,0,1,2,3,1992,194.0
738,738,44,HRV,0,1,2,3,1992,288.0
739,739,44,IRN,0,1,2,3,1992,196.0
740,740,48,ISR,0,1,1,2,1992,178.0
741,741,49,TWN,0,1,0,1,1992,271.0
742,742,49,MEX,0,1,0,1,1992,177.0
743,743,49,PER,0,1,0,1,1992,171.0
744,744,52,MNG,0,0,2,2,1992,118.0
745,745,52,SVN,0,0,2,2,1992,143.0
746,746,54,ARG,0,0,1,1,1992,82.0
747,747,54,BHS,0,0,1,1,1992,69.0
748,748,54,COL,0,0,1,1,1992,15.0
749,749,54,GHA,0,0,1,1,1992,12.0
750,750,54,MYS,0,0,1,1,1992,11.0
751,751,54,PAK,0,0,1,1,1992,19.0
752,752,54,PHL,0,0,1,1,1992,24.0
753,753,54,PRI,0,0,1,1,1992,24.0
754,754,54,QAT,0,0,1,1,1992,21.0
755,755,54,SUR,0,0,1,1,1992,18.0
756,756,54,THA,0,0,1,1,1992,13.0
757,757,1,USA,44,32,25,101,1996,21.0
758,758,2,RUS,26,21,16,63,1996,23.0
759,759,3,DEU,20,18,27,65,1996,23.0
760,760,4,CHN,16,22,12,50,1996,169.0
761,761,5,FRA,15,7,15,37,1996,162.0
762,762,6,ITA,13,10,12,35,1996,171.0
763,763,7,AUS,9,9,23,41,1996,158.0
764,764,8,CUB,9,8,8,25,1996,159.0
765,765,9,UKR,9,2,12,23,1996,135.0
766,766,10,KOR,7,15,5,27,1996,151.0
767,767,11,POL,7,5,5,17,1996,149.0
768,768,12,HUN,7,4,10,21,1996,15.0
769,769,13,ESP,5,6,6,17,1996,36.0
770,770,14,ROU,4,7,9,20,1996,68.0
771,771,15,NLD,4,5,10,19,1996,107.0
772,772,16,GRC,4,4,0,8,1996,233.0
773,773,17,CZE,4,3,4,11,1996,246.0
774,774,18,CHE,4,3,0,7,1996,158.0
775,775,19,DNK,4,1,1,6,1996,122.0
776,776,19,TUR,4,1,1,6,1996,94.0
777,777,21,CAN,3,11,8,22,1996,173.0
778,778,22,BGR,3,7,5,15,1996,253.0
779,779,23,JPN,3,6,5,14,1996,201.0
780,780,24,KAZ,3,4,4,11,1996,51.0
781,781,25,BRA,3,3,9,15,1996,109.0
782,782,26,NZL,3,2,1,6,1996,71.0
783,783,27,ZAF,3,1,1,5,1996,93.0
784,784,28,IRL,3,0,1,4,1996,155.0
785,785,29,SWE,2,4,2,8,1996,81.0
786,786,30,NOR,2,2,3,7,1996,60.0
787,787,31,BEL,2,2,2,6,1996,74.0
788,788,32,NGA,2,1,3,6,1996,130.0
789,789,33,PRK,2,1,2,5,1996,144.0
790,790,34,DZA,2,0,1,3,1996,145.0
791,791,34,ETH,2,0,1,3,1996,124.0
792,792,36,GBR,1,8,6,15,1996,115.0
793,793,37,BLR,1,6,8,15,1996,108.0
794,794,38,KEN,1,4,3,8,1996,149.0
795,795,39,JAM,1,3,2,6,1996,143.0
796,796,40,FIN,1,2,1,4,1996,138.0
797,797,41,YUG,1,1,2,4,1996,161.0
798,798,41,IDN,1,1,2,4,1996,3.0
799,799,43,IRN,1,1,1,3,1996,6.0
800,800,43,SVK,1,1,1,3,1996,8.0
801,801,45,ARM,1,1,0,2,1996,5.0
802,802,45,HRV,1,1,0,2,1996,2.0
803,803,47,PRT,1,0,1,2,1996,2.0
804,804,47,THA,1,0,1,2,1996,4.0
805,805,49,BDI,1,0,0,1,1996,8.0
806,806,49,CRI,1,0,0,1,1996,5.0
807,807,49,ECU,1,0,0,1,1996,7.0
808,808,49,HKG,1,0,0,1,1996,6.0
809,809,49,SYR,1,0,0,1,1996,4.0
810,810,54,ARG,0,2,1,3,1996,2.0
811,811,55,NAM,0,2,0,2,1996,2.0
812,812,55,SVN,0,2,0,2,1996,2.0
813,813,57,AUT,0,1,2,3,1996,2.0
814,814,58,MYS,0,1,1,2,1996,2.0
815,815,58,MDA,0,1,1,2,1996,4.0
816,816,58,UZB,0,1,1,2,1996,1.0
817,817,61,AZE,0,1,0,1,1996,24.0
818,818,61,BHS,0,1,0,1,1996,5.0
819,819,61,TWN,0,1,0,1,1996,11.0
820,820,61,LVA,0,1,0,1,1996,7.0
821,821,61,PHL,0,1,0,1,1996,24.0
822,822,61,TON,0,1,0,1,1996,18.0
823,823,61,ZMB,0,1,0,1,1996,32.0
824,824,68,GEO,0,0,2,2,1996,16.0
825,825,68,MAR,0,0,2,2,1996,13.0
826,826,68,TTO,0,0,2,2,1996,33.0
827,827,71,IND,0,0,1,1,1996,27.0
828,828,71,ISR,0,0,1,1,1996,36.0
829,829,71,LTU,0,0,1,1,1996,30.0
830,830,71,MEX,0,0,1,1,1996,69.0
831,831,71,MNG,0,0,1,1,1996,64.0
832,832,71,MOZ,0,0,1,1,1996,4.0
833,833,71,PRI,0,0,1,1,1996,41.0
834,834,71,TUN,0,0,1,1,1996,4.0
835,835,71,UGA,0,0,1,1,1996,8.0
836,836,1,USA,37,24,32,93,2000,16.0
837,837,2,RUS,32,28,29,89,2000,15.0
838,838,3,CHN,28,16,14,58,2000,15.0
839,839,4,AUS,16,25,17,58,2000,15.0
840,840,5,DEU,13,17,26,56,2000,28.0
841,841,6,FRA,13,14,11,38,2000,11.0
842,842,7,ITA,13,8,13,34,2000,18.0
843,843,8,NLD,12,9,4,25,2000,26.0
844,844,9,CUB,11,11,7,29,2000,36.0
845,845,10,GBR,11,10,7,28,2000,40.0
846,846,11,ROU,11,6,9,26,2000,52.0
847,847,12,KOR,8,10,10,28,2000,47.0
848,848,13,HUN,8,6,3,17,2000,5.0
849,849,14,POL,6,5,3,14,2000,22.0
850,850,15,JPN,5,8,5,18,2000,30.0
851,851,16,BGR,5,6,2,13,2000,43.0
852,852,17,GRC,4,6,3,13,2000,66.0
853,853,18,SWE,4,5,3,12,2000,166.0
854,854,19,NOR,4,3,3,10,2000,196.0
855,855,20,ETH,4,1,3,8,2000,6.0
856,856,21,UKR,3,10,10,23,2000,83.0
857,857,22,KAZ,3,4,0,7,2000,35.0
858,858,23,BLR,3,3,11,17,2000,26.0
859,859,24,CAN,3,3,8,14,2000,26.0
860,860,25,ESP,3,3,5,11,2000,148.0
861,861,26,TUR,3,0,2,5,2000,59.0
862,862,27,IRN,3,0,1,4,2000,83.0
863,863,28,CZE,2,3,3,8,2000,33.0
864,864,29,KEN,2,3,2,7,2000,103.0
865,865,30,DNK,2,3,1,6,2000,104.0
866,866,31,FIN,2,1,1,4,2000,116.0
867,867,32,AUT,2,1,0,3,2000,132.0
868,868,33,LTU,2,0,3,5,2000,137.0
869,869,34,AZE,2,0,1,3,2000,195.0
870,870,34,BHS,2,0,1,3,2000,207.0
871,871,36,SVN,2,0,0,2,2000,35.0
872,872,37,CHE,1,6,2,9,2000,44.0
873,873,38,IDN,1,3,2,6,2000,3.0
874,874,39,SVK,1,3,1,5,2000,5.0
875,875,40,MEX,1,2,3,6,2000,11.0
876,876,41,NGA,1,2,0,3,2000,12.0
877,877,42,DZA,1,1,3,5,2000,12.0
878,878,43,UZB,1,1,2,4,2000,14.0
879,879,44,YUG,1,1,1,3,2000,12.0
880,880,44,LVA,1,1,1,3,2000,4.0
881,881,46,NZL,1,0,3,4,2000,104.0
882,882,47,EST,1,0,2,3,2000,18.0
883,883,47,THA,1,0,2,3,2000,15.0
884,884,49,HRV,1,0,1,2,2000,7.0
885,885,50,CMR,1,0,0,1,2000,6.0
886,886,50,COL,1,0,0,1,2000,10.0
887,887,50,MOZ,1,0,0,1,2000,10.0
888,888,53,BRA,0,6,6,12,2000,9.0
889,889,54,JAM,0,6,3,9,2000,14.0
890,890,55,BEL,0,2,3,5,2000,11.0
891,891,55,ZAF,0,2,3,5,2000,10.0
892,892,57,ARG,0,2,2,4,2000,7.0
893,893,58,TWN,0,1,4,5,2000,9.0
894,894,58,MAR,0,1,4,5,2000,12.0
895,895,60,PRK,0,1,3,4,2000,111.0
896,896,61,MDA,0,1,1,2,2000,151.0
897,897,61,SAU,0,1,1,2,2000,106.0
898,898,61,TTO,0,1,1,2,2000,8.0
899,899,64,IRL,0,1,0,1,2000,84.0
900,900,64,LKA,0,1,0,1,2000,42.0
901,901,64,URY,0,1,0,1,2000,12.0
902,902,64,VNM,0,1,0,1,2000,238.0
903,903,68,GEO,0,0,6,6,2000,67.0
904,904,69,CRI,0,0,2,2,2000,137.0
905,905,69,PRT,0,0,2,2,2000,162.0
906,906,71,ARM,0,0,1,1,2000,160.0
907,907,71,BRB,0,0,1,1,2000,211.0
908,908,71,CHL,0,0,1,1,2000,257.0
909,909,71,ISL,0,0,1,1,2000,317.0
910,910,71,IND,0,0,1,1,2000,537.0
911,911,71,ISR,0,0,1,1,2000,384.0
912,912,71,KWT,0,0,1,1,2000,431.0
913,913,71,KGZ,0,0,1,1,2000,423.0
914,914,71,MKD,0,0,1,1,2000,355.0
915,915,71,QAT,0,0,1,1,2000,339.0
916,916,1,USA,36,39,26,101,2004,363.0
917,917,2,CHN,32,17,14,63,2004,429.0
918,918,3,RUS,28,26,36,90,2004,526.0
919,919,4,AUS,17,16,17,50,2004,20.0
920,920,5,JPN,16,9,12,37,2004,47.0
921,921,6,DEU,13,16,20,49,2004,23.0
922,922,7,FRA,11,9,13,33,2004,3.0
923,923,8,ITA,10,11,11,32,2004,36.0
924,924,9,KOR,9,12,9,30,2004,46.0
925,925,10,GBR,9,9,12,30,2004,52.0
926,926,11,CUB,9,7,11,27,2004,41.0
927,927,12,HUN,8,6,3,17,2004,45.0
928,928,13,UKR,8,5,9,22,2004,53.0
929,929,14,ROU,8,5,6,19,2004,36.0
930,930,15,GRC,6,6,4,16,2004,49.0
931,931,16,BRA,5,2,3,10,2004,42.0
932,932,17,NOR,5,0,1,6,2004,26.0
933,933,18,NLD,4,9,9,22,2004,30.0
934,934,19,SWE,4,2,1,7,2004,15.0
935,935,20,ESP,3,11,6,20,2004,19.0
936,936,21,CAN,3,6,3,12,2004,26.0
937,937,22,TUR,3,3,4,10,2004,40.0
938,938,23,POL,3,2,5,10,2004,48.0
939,939,24,NZL,3,2,0,5,2004,24.0
940,940,25,THA,3,1,4,8,2004,19.0
941,941,26,BLR,2,5,6,13,2004,27.0
942,942,27,AUT,2,4,1,7,2004,27.0
943,943,28,ETH,2,3,2,7,2004,29.0
944,944,29,IRN,2,2,2,6,2004,34.0
945,945,29,SVK,2,2,2,6,2004,38.0
946,946,31,TWN,2,2,1,5,2004,38.0
947,947,32,GEO,2,2,0,4,2004,35.0
948,948,33,BGR,2,1,9,12,2004,650.0
949,949,34,DNK,2,1,5,8,2004,5.0
950,950,35,JAM,2,1,2,5,2004,3.0
951,951,35,UZB,2,1,2,5,2004,1.0
952,952,37,MAR,2,1,0,3,2004,4.0
953,953,38,ARG,2,0,4,6,2004,5.0
954,954,39,CHL,2,0,1,3,2004,26.0
955,955,40,KAZ,1,4,3,8,2004,41.0
956,956,41,KEN,1,4,2,7,2004,36.0
957,957,42,CZE,1,3,5,9,2004,21.0
958,958,43,ZAF,1,3,2,6,2004,9.0
959,959,44,HRV,1,2,2,5,2004,9.0
960,960,45,LTU,1,2,0,3,2004,6.0
961,961,46,EGY,1,1,3,5,2004,9.0
962,962,46,CHE,1,1,3,5,2004,53.0
963,963,48,IDN,1,1,2,4,2004,32.0
964,964,49,ZWE,1,1,1,3,2004,36.0
965,965,50,AZE,1,0,4,5,2004,18.0
966,966,51,BEL,1,0,2,3,2004,94.0
967,967,52,BHS,1,0,1,2,2004,233.0
968,968,52,ISR,1,0,1,2,2004,136.0
969,969,54,CMR,1,0,0,1,2004,253.0
970,970,54,DOM,1,0,0,1,2004,132.0
971,971,54,ARE,1,0,0,1,2004,66.0
972,972,57,PRK,0,4,1,5,2004,186.0
973,973,58,LVA,0,4,0,4,2004,215.0
974,974,59,MEX,0,3,1,4,2004,412.0
975,975,60,PRT,0,2,1,3,2004,147.0
976,976,61,FIN,0,2,0,2,2004,219.0
978,978,63,SVN,0,1,3,4,2004,126.0
979,979,64,EST,0,1,2,3,2004,133.0
980,980,65,HKG,0,1,0,1,2004,108.0
981,981,65,IND,0,1,0,1,2004,125.0
982,982,65,PRY,0,1,0,1,2004,107.0
983,983,68,COL,0,0,2,2,2004,101.0
984,984,68,NGA,0,0,2,2,2004,130.0
985,985,68,VEN,0,0,2,2,2004,105.0
986,986,71,ERI,0,0,1,1,2004,88.0
987,987,71,MNG,0,0,1,1,2004,67.0
988,988,71,SYR,0,0,1,1,2004,70.0
989,989,71,TTO,0,0,1,1,2004,69.0
990,990,1,CHN,48,22,30,100,2008,67.0
991,991,2,USA,36,39,37,112,2008,49.0
992,992,3,RUS,24,13,23,60,2008,62.0
993,993,4,GBR,19,13,19,51,2008,26.0
994,994,5,DEU,16,11,14,41,2008,1071.0
995,995,6,AUS,14,15,17,46,2008,2.0
996,996,7,KOR,13,11,8,32,2008,174.0
997,997,8,JPN,9,8,8,25,2008,319.0
998,998,9,ITA,8,9,10,27,2008,232.0
999,999,10,FRA,7,16,20,43,2008,452.0
1000,1000,11,NLD,7,5,4,16,2008,636.0
1001,1001,12,UKR,7,4,11,22,2008,422.0
1002,1002,13,KEN,6,4,6,16,2008,159.0
1003,1003,14,ESP,5,11,3,19,2008,303.0
1004,1004,15,JAM,5,4,2,11,2008,433.0
1005,1005,16,POL,4,5,2,11,2008,408.0
1006,1006,17,ETH,4,2,1,7,2008,227.0
1007,1007,18,ROU,4,1,4,9,2008,363.0
1008,1008,19,CUB,3,10,17,30,2008,214.0
1009,1009,20,CAN,3,9,8,20,2008,311.0
1010,1010,21,HUN,3,5,2,10,2008,356.0
1011,1011,22,NOR,3,5,1,9,2008,302.0
1012,1012,23,BRA,3,4,10,17,2008,200.0
1013,1013,24,BLR,3,4,7,14,2008,354.0
1014,1014,25,CZE,3,3,1,7,2008,413.0
1015,1015,26,SVK,3,3,0,6,2008,486.0
1016,1016,27,NZL,3,2,4,9,2008,453.0
1017,1017,28,GEO,3,2,2,7,2008,470.0
1018,1018,29,KAZ,2,3,4,9,2008,461.0
1019,1019,30,DNK,2,2,3,7,2008,448.0
1020,1020,31,PRK,2,2,2,6,2008,426.0
1021,1021,31,THA,2,2,2,6,2008,512.0
1022,1022,33,MNG,2,2,0,4,2008,538.0
1023,1023,34,CHE,2,1,4,7,2008,801.0
1024,1024,35,ARG,2,0,4,6,2008,432.0
1025,1025,36,MEX,2,0,2,4,2008,587.0
1026,1026,37,BEL,2,0,0,2,2008,452.0
1027,1027,38,ZWE,1,3,0,4,2008,571.0
1028,1028,39,SVN,1,2,2,5,2008,516.0
1029,1029,40,AZE,1,1,4,6,2008,5.0
1030,1030,40,IDN,1,1,4,6,2008,5.0
1031,1031,42,BGR,1,1,3,5,2008,5.0
1032,1032,42,TUR,1,1,3,5,2008,6.0
1033,1033,44,TWN,1,1,2,4,2008,5.0
1034,1034,44,FIN,1,1,2,4,2008,3.0
1035,1035,46,LVA,1,1,1,3,2008,3.0
1036,1036,47,DOM,1,1,0,2,2008,1.0
1037,1037,47,EST,1,1,0,2,2008,4.0
1038,1038,47,PRT,1,1,0,2,2008,2.0
1039,1039,47,TTO,1,1,0,2,2008,5.0
1040,1040,51,IND,1,0,2,3,2008,9.0
1041,1041,52,IRN,1,0,1,2,2008,6.0
1042,1042,53,CMR,1,0,0,1,2008,5.0
1043,1043,53,PAN,1,0,0,1,2008,4.0
1044,1044,53,TUN,1,0,0,1,2008,21.0
1045,1045,56,SWE,0,4,1,5,2008,6.0
1046,1046,57,LTU,0,3,2,5,2008,5.0
1047,1047,57,NGA,0,3,2,5,2008,5.0
1048,1048,59,HRV,0,2,3,5,2008,16.0
1049,1049,60,COL,0,2,1,3,2008,6.0
1050,1050,60,GRC,0,2,1,3,2008,8.0
1051,1051,62,ARM,0,1,4,5,2008,12.0
1052,1052,63,UZB,0,1,3,4,2008,2.0
1053,1053,64,AUT,0,1,2,3,2008,3.0
1054,1054,64,IRL,0,1,2,3,2008,3.0
1055,1055,64,KGZ,0,1,2,3,2008,2.0
1056,1056,64,SRB,0,1,2,3,2008,4.0
1057,1057,68,DZA,0,1,1,2,2008,5.0
1058,1058,68,BHS,0,1,1,2,2008,8.0
1059,1059,68,MAR,0,1,1,2,2008,25.0
1060,1060,68,TJK,0,1,1,2,2008,146.0
1061,1061,72,CHL,0,1,0,1,2008,6.0
1062,1062,72,ECU,0,1,0,1,2008,113.0
1063,1063,72,ISL,0,1,0,1,2008,972.0
1064,1064,72,MYS,0,1,0,1,2008,461.0
1065,1065,72,WSM,0,1,0,1,2008,345.0
1066,1066,72,SGP,0,1,0,1,2008,428.0
1067,1067,72,ZAF,0,1,0,1,2008,354.0
1068,1068,72,SDN,0,1,0,1,2008,170.0
1069,1069,72,VNM,0,1,0,1,2008,250.0
1070,1070,81,EGY,0,0,2,2,2008,590.0
1071,1071,82,AFG,0,0,1,1,2008,401.0
1072,1072,82,ISR,0,0,1,1,2008,283.0
1073,1073,82,MUS,0,0,1,1,2008,389.0
1074,1074,82,MDA,0,0,1,1,2008,301.0
1075,1075,82,TGO,0,0,1,1,2008,328.0
1076,1076,82,VEN,0,0,1,1,2008,433.0
1077,1077,1,USA,48,26,30,104,2012,353.0
1078,1078,2,CHN,39,31,22,92,2012,328.0
1079,1079,3,GBR,29,18,18,65,2012,509.0
1080,1080,4,RUS,18,21,26,65,2012,472.0
1081,1081,5,KOR,13,9,9,31,2012,512.0
1082,1082,6,DEU,11,20,13,44,2012,391.0
1083,1083,7,FRA,11,11,13,35,2012,415.0
1084,1084,8,AUS,8,15,12,35,2012,360.0
1085,1085,9,ITA,8,9,11,28,2012,420.0
1086,1086,10,HUN,8,4,6,18,2012,684.0
1087,1087,11,JPN,7,14,17,38,2012,478.0
1088,1088,12,IRN,7,5,1,13,2012,548.0
1089,1089,13,NLD,6,6,8,20,2012,533.0
1090,1090,14,NZL,6,2,5,13,2012,3.0
1091,1091,15,UKR,5,4,10,19,2012,3.0
1092,1092,16,CUB,5,3,7,15,2012,3.0
1093,1093,17,ESP,4,10,6,20,2012,3.0
1094,1094,18,JAM,4,5,4,13,2012,4.0
1095,1095,19,CZE,4,4,3,11,2012,5.0
1096,1096,20,ZAF,4,1,1,6,2012,4.0
1097,1097,21,PRK,4,0,2,6,2012,6.0
1098,1098,22,BRA,3,5,9,17,2012,346.0
1099,1099,23,KAZ,3,2,6,11,2012,454.0
1100,1100,23,POL,3,2,6,11,2012,407.0
1101,1101,25,ETH,3,2,3,8,2012,495.0
1102,1102,26,HRV,3,1,2,6,2012,402.0
1103,1103,27,CAN,2,6,10,18,2012,42.0
1104,1104,28,BLR,2,5,3,10,2012,47.0
1105,1105,29,KEN,2,4,7,13,2012,39.0
1106,1106,30,DNK,2,4,3,9,2012,38.0
1107,1107,31,ROU,2,4,1,7,2012,36.0
1108,1108,32,AZE,2,2,5,9,2012,45.0
1109,1109,33,CHE,2,2,0,4,2012,36.0
1110,1110,34,NOR,2,1,1,4,2012,38.0
1111,1111,35,LTU,2,0,3,5,2012,5.0
1112,1112,36,TUN,2,0,1,3,2012,7.0
1113,1113,37,SWE,1,4,3,8,2012,8.0
1114,1114,38,COL,1,3,5,9,2012,8.0
1115,1115,39,MEX,1,3,4,8,2012,4.0
1116,1116,40,GEO,1,2,3,6,2012,2.0
1117,1117,41,IRL,1,1,4,6,2012,3.0
1118,1118,42,ARG,1,1,2,4,2012,2.0
1119,1119,42,SRB,1,1,2,4,2012,1.0
1120,1120,42,SVN,1,1,2,4,2012,3.0
1121,1121,42,TTO,1,1,2,4,2012,3.0
1122,1122,46,TUR,1,1,1,3,2012,94.0
1123,1123,47,DOM,1,1,0,2,2012,103.0
1124,1124,48,TWN,1,0,1,2,2012,55.0
1125,1125,48,LVA,1,0,1,2,2012,157.0
1126,1126,50,DZA,1,0,0,1,2012,148.0
1127,1127,50,BHS,1,0,0,1,2012,312.0
1128,1128,50,BHR,1,0,0,1,2012,399.0
1129,1129,50,GRD,1,0,0,1,2012,202.0
1130,1130,50,UGA,1,0,0,1,2012,581.0
1131,1131,50,VEN,1,0,0,1,2012,365.0
1132,1132,56,EGY,0,3,1,4,2012,261.0
1133,1133,57,IND,0,2,4,6,2012,425.0
1134,1134,58,MNG,0,2,3,5,2012,478.0
1135,1135,59,THA,0,2,2,4,2012,653.0
1136,1136,60,BGR,0,2,1,3,2012,626.0
1137,1137,60,FIN,0,2,1,3,2012,567.0
1138,1138,60,IDN,0,2,1,3,2012,592.0
1139,1139,63,SVK,0,1,3,4,2012,558.0
1140,1140,64,BEL,0,1,2,3,2012,510.0
1141,1141,65,ARM,0,1,1,2,2012,536.0
1142,1142,65,EST,0,1,1,2,2012,597.0
1143,1143,65,MYS,0,1,1,2,2012,647.0
1144,1144,65,PRI,0,1,1,2,2012,9.0
1145,1145,65,QAT,0,1,1,2,2012,15.0
1146,1146,70,BWA,0,1,0,1,2012,40.0
1147,1147,70,CYP,0,1,0,1,2012,36.0
1148,1148,70,GAB,0,1,0,1,2012,41.0
1149,1149,70,GTM,0,1,0,1,2012,27.0
1150,1150,70,MNE,0,1,0,1,2012,21.0
1151,1151,70,PRT,0,1,0,1,2012,41.0
1152,1152,76,UZB,0,0,3,3,2012,40.0
1153,1153,77,GRC,0,0,2,2,2012,28.0
1154,1154,77,SGP,0,0,2,2,2012,29.0
1155,1155,79,AFG,0,0,1,1,2012,9.0
1156,1156,79,CMR,0,0,1,1,2012,7.0
1157,1157,79,HKG,0,0,1,1,2012,15.0
1158,1158,79,KWT,0,0,1,1,2012,16.0
1159,1159,79,MAR,0,0,1,1,2012,11.0
1160,1160,79,SAU,0,0,1,1,2012,148.0
1161,1161,79,TJK,0,0,1,1,2012,4.0
1162,1162,79,VNM,0,0,1,1,2012,17.0
1163,1163,1,USA,46,37,38,121,2016,484.0
1164,1164,2,GBR,27,23,17,67,2016,49.0
1165,1165,3,CHN,26,18,26,70,2016,77.0
1166,1166,4,RUS,19,17,20,56,2016,98.0
1167,1167,5,DEU,17,10,15,42,2016,79.0
1168,1168,6,JPN,12,8,21,41,2016,47.0
1169,1169,7,FRA,10,18,14,42,2016,16.0
1170,1170,8,KOR,9,3,9,21,2016,64.0
1171,1171,9,ITA,8,12,8,28,2016,97.0
1172,1172,10,AUS,8,11,10,29,2016,54.0
1173,1173,11,NLD,8,7,4,19,2016,16.0
1174,1174,12,HUN,8,3,4,15,2016,59.0
1175,1175,13,BRA,7,6,6,19,2016,19.0
1176,1176,14,ESP,7,4,6,17,2016,44.0
1177,1177,15,KEN,6,6,1,13,2016,66.0
1178,1178,16,JAM,6,3,2,11,2016,40.0
1179,1179,17,HRV,5,3,2,10,2016,45.0
1180,1180,18,CUB,5,2,4,11,2016,73.0
1181,1181,19,NZL,4,9,5,18,2016,72.0
1182,1182,20,CAN,4,3,15,22,2016,76.0
1183,1183,21,UZB,4,2,7,13,2016,180.0
1184,1184,22,COL,3,2,3,8,2016,175.0
1185,1185,23,CHE,3,2,2,7,2016,499.0
1186,1186,24,IRN,3,1,4,8,2016,176.0
1187,1187,25,GRC,3,1,2,6,2016,115.0
1188,1188,26,ARG,3,1,0,4,2016,104.0
1189,1189,27,DNK,2,6,7,15,2016,100.0
1190,1190,28,SWE,2,6,3,11,2016,126.0
1191,1191,29,ZAF,2,6,2,10,2016,6.0
1192,1192,30,KAZ,2,5,10,17,2016,7.0
1193,1193,31,UKR,2,5,4,11,2016,5.0
1194,1194,32,SRB,2,4,2,8,2016,5.0
1195,1195,33,POL,2,3,6,11,2016,3.0
1196,1196,34,PRK,2,3,2,7,2016,5.0
1197,1197,35,BEL,2,2,2,6,2016,9.0
1198,1198,35,THA,2,2,2,6,2016,8.0
1199,1199,37,SVK,2,2,0,4,2016,6.0
1200,1200,38,GEO,2,1,4,7,2016,6.0
1201,1201,39,AZE,1,7,10,18,2016,6.0
1202,1202,40,BLR,1,4,4,9,2016,1.0
1203,1203,41,TUR,1,3,4,8,2016,35.0
1204,1204,42,ARM,1,3,0,4,2016,67.0
1205,1205,43,CZE,1,2,7,10,2016,11.0
1206,1206,44,ETH,1,2,5,8,2016,28.0
1207,1207,45,SVN,1,2,1,4,2016,10.0
1208,1208,46,IDN,1,2,0,3,2016,53.0
1209,1209,47,ROU,1,1,2,4,2016,37.0
1210,1210,48,BHR,1,1,0,2,2016,41.0
1211,1211,48,VNM,1,1,0,2,2016,28.0
1212,1212,50,TWN,1,0,2,3,2016,18.0
1213,1213,51,BHS,1,0,1,2,2016,19.0
1214,1214,51,CIV,1,0,1,2,2016,13.0
1215,1215,54,FJI,1,0,0,1,2016,24.0
1216,1216,54,JOR,1,0,0,1,2016,25.0
1218,1218,54,PRI,1,0,0,1,2016,16.0
1219,1219,54,SGP,1,0,0,1,2016,15.0
1220,1220,54,TJK,1,0,0,1,2016,10.0
1221,1221,60,MYS,0,4,1,5,2016,1.0
1222,1222,61,MEX,0,3,2,5,2016,7.0
1223,1223,62,VEN,0,2,1,3,2016,11.0
1224,1224,63,DZA,0,2,0,2,2016,5.0
1225,1225,63,IRL,0,2,0,2,2016,6.0
1226,1226,65,LTU,0,1,3,4,2016,4.0
1227,1227,66,BGR,0,1,2,3,2016,5.0
1228,1228,67,IND,0,1,1,2,2016,4.0
1229,1229,67,MNG,0,1,1,2,2016,5.0
1230,1230,69,BDI,0,1,0,1,2016,5.0
1231,1231,69,GRD,0,1,0,1,2016,25.0
1232,1232,69,NER,0,1,0,1,2016,26.0
1233,1233,69,PHL,0,1,0,1,2016,45.0
1234,1234,69,QAT,0,1,0,1,2016,9.0
1235,1235,74,NOR,0,0,4,4,2016,7.0
1236,1236,75,EGY,0,0,3,3,2016,4.0
1237,1237,75,TUN,0,0,3,3,2016,7.0
1238,1238,77,ISR,0,0,2,2,2016,8.0
1239,1239,78,AUT,0,0,1,1,2016,5.0
1240,1240,78,DOM,0,0,1,1,2016,5.0
1241,1241,78,EST,0,0,1,1,2016,9.0
1242,1242,78,FIN,0,0,1,1,2016,7.0
1243,1243,78,MAR,0,0,1,1,2016,1.0
1244,1244,78,NGA,0,0,1,1,2016,6.0
1245,1245,78,PRT,0,0,1,1,2016,6.0
1246,1246,78,TTO,0,0,1,1,2016,1.0
1247,1247,78,ARE,0,0,1,1,2016,6.0
1248,1248,1,USA,39,41,33,113,2020,4.0
1249,1249,2,CHN,38,32,19,89,2020,10.0
1250,1250,3,JPN,27,14,17,58,2020,12.0
1251,1251,4,GBR,22,20,22,64,2020,8.0
1253,1253,6,AUS,17,7,22,46,2020,9.0
1254,1254,7,NLD,10,12,14,36,2020,4.0
1255,1255,8,FRA,10,12,11,33,2020,4.0
1256,1256,9,DEU,10,11,16,37,2020,4.0
1257,1257,10,ITA,10,10,20,40,2020,6.0
1258,1258,11,CAN,7,7,10,24,2020,7.0
1259,1259,12,BRA,7,6,8,21,2020,7.0
1260,1260,13,NZL,7,6,7,20,2020,5.0
1261,1261,14,CUB,7,3,5,15,2020,4.0
1262,1262,15,HUN,6,7,7,20,2020,16.0
1263,1263,16,KOR,6,4,10,20,2020,3.0
1264,1264,17,POL,4,5,5,14,2020,3.0
1265,1265,18,CZE,4,4,3,11,2020,1.0
1266,1266,19,KEN,4,4,2,10,2020,7.0
1267,1267,20,NOR,4,2,2,8,2020,14.0
1268,1268,21,JAM,4,1,4,9,2020,3.0
1269,1269,22,ESP,3,8,6,17,2020,5.0
1270,1270,23,SWE,3,6,0,9,2020,8.0
1271,1271,24,CHE,3,4,6,13,2020,7.0
1272,1272,25,DNK,3,4,4,11,2020,5.0
1273,1273,26,HRV,3,3,2,8,2020,8.0
1274,1274,27,IRN,3,2,2,7,2020,7.0
1275,1275,28,SRB,3,1,5,9,2020,5.0
1276,1276,29,BEL,3,1,3,7,2020,10.0
1277,1277,30,BGR,3,1,2,6,2020,6.0
1278,1278,31,SVN,3,1,1,5,2020,12.0
1279,1279,32,UZB,3,0,2,5,2020,9.0
1280,1280,33,GEO,2,5,1,8,2020,4.0
1281,1281,34,TWN,2,4,6,12,2020,4.0
1282,1282,35,TUR,2,2,9,13,2020,50.0
1283,1283,36,GRC,2,1,1,4,2020,25.0
1284,1284,36,UGA,2,1,1,4,2020,18.0
1285,1285,38,ECU,2,1,0,3,2020,50.0
1286,1286,39,IRL,2,0,2,4,2020,87.0
1287,1287,39,ISR,2,0,2,4,2020,91.0
1288,1288,41,QAT,2,0,1,3,2020,66.0
1289,1289,42,BHS,2,0,0,2,2020,32.0
1291,1291,44,UKR,1,6,12,19,2020,42.0
1292,1292,45,BLR,1,3,3,7,2020,47.0
1293,1293,46,ROU,1,3,0,4,2020,55.0
1294,1294,46,VEN,1,3,0,4,2020,47.0
1295,1295,48,IND,1,2,4,7,2020,65.0
1296,1296,49,HKG,1,2,3,6,2020,51.0
1297,1297,50,PHL,1,2,1,4,2020,6.0
1298,1298,50,SVK,1,2,1,4,2020,3.0
1299,1299,52,ZAF,1,2,0,3,2020,26.0
1300,1300,53,AUT,1,1,5,7,2020,18.0
1301,1301,54,EGY,1,1,4,6,2020,27.0
1302,1302,55,IDN,1,1,3,5,2020,7.0
1303,1303,56,ETH,1,1,2,4,2020,20.0
1304,1304,56,PRT,1,1,2,4,2020,5.0
1305,1305,58,TUN,1,1,0,2,2020,26.0
1306,1306,59,EST,1,0,1,2,2020,25.0
1307,1307,59,FJI,1,0,1,2,2020,23.0
1308,1308,59,LVA,1,0,1,2,2020,28.0
1309,1309,59,THA,1,0,1,2,2020,4.0
1310,1310,63,BMU,1,0,0,1,2020,18.0
1311,1311,63,MAR,1,0,0,1,2020,34.0
1312,1312,63,PRI,1,0,0,1,2020,9.0
1313,1313,66,COL,0,4,1,5,2020,99.0
1314,1314,67,AZE,0,3,4,7,2020,107.0
1315,1315,68,DOM,0,3,2,5,2020,207.0
1316,1316,69,ARM,0,2,2,4,2020,140.0
1317,1317,70,KGZ,0,2,1,3,2020,219.0
1318,1318,71,MNG,0,1,3,4,2020,118.0
1319,1319,72,ARG,0,1,2,3,2020,335.0
1320,1320,72,SMR,0,1,2,3,2020,222.0
1321,1321,74,JOR,0,1,1,2,2020,345.0
1322,1322,74,MYS,0,1,1,2,2020,197.0
1323,1323,74,NGA,0,1,1,2,2020,312.0
1324,1324,77,BHR,0,1,0,1,2020,319.0
1325,1325,77,LTU,0,1,0,1,2020,303.0
1326,1326,77,NAM,0,1,0,1,2020,367.0
1327,1327,77,MKD,0,1,0,1,2020,288.0
1328,1328,77,SAU,0,1,0,1,2020,392.0
1329,1329,77,TKM,0,1,0,1,2020,315.0
1330,1330,83,KAZ,0,0,8,8,2020,351.0
1331,1331,84,MEX,0,0,4,4,2020,315.0
1332,1332,85,FIN,0,0,2,2,2020,238.0
1333,1333,86,BWA,0,0,1,1,2020,258.0
1334,1334,86,BFA,0,0,1,1,2020,216.0
1335,1335,86,GHA,0,0,1,1,2020,201.0
1336,1336,86,GRD,0,0,1,1,2020,204.0
1337,1337,86,CIV,0,0,1,1,2020,237.0
1338,1338,86,KWT,0,0,1,1,2020,255.0
1339,1339,86,MDA,0,0,1,1,2020,3.0
1340,1340,86,SYR,0,0,1,1,2020,24.0
1341,1341,1,USA,40,44,42,126,2024,27.0
1342,1342,2,CHN,40,27,24,91,2024,6.0
1343,1343,3,JPN,20,12,13,45,2024,7.0
1344,1344,4,AUS,18,19,16,53,2024,11.0
1345,1345,5,FRA,16,26,22,64,2024,23.0
1346,1346,6,NLD,15,7,12,34,2024,43.0
1347,1347,7,GBR,14,22,29,65,2024,51.0
1348,1348,8,KOR,13,9,10,32,2024,45.0
1349,1349,9,ITA,12,13,15,40,2024,54.0
1350,1350,10,DEU,12,13,8,33,2024,39.0
1351,1351,11,NZL,10,7,3,20,2024,26.0
1352,1352,12,CAN,9,7,11,27,2024,22.0
1353,1353,13,UZB,8,2,3,13,2024,31.0
1354,1354,14,HUN,6,7,6,19,2024,35.0
1355,1355,15,ESP,5,4,9,18,2024,36.0
1356,1356,16,SWE,4,4,3,11,2024,5.0
1357,1357,17,KEN,4,2,5,11,2024,7.0
1358,1358,18,NOR,4,1,3,8,2024,24.0
1359,1359,19,IRL,4,0,3,7,2024,24.0
1360,1360,20,BRA,3,7,10,20,2024,26.0
1361,1361,21,IRN,3,6,3,12,2024,30.0
1362,1362,22,UKR,3,5,4,12,2024,89.0
1363,1363,23,ROU,3,4,2,9,2024,94.0
1364,1364,24,GEO,3,3,1,7,2024,79.0
1365,1365,25,BEL,3,1,6,10,2024,49.0
1366,1366,26,BGR,3,1,3,7,2024,111.0
1367,1367,27,SRB,3,1,1,5,2024,27.0
1368,1368,28,CZE,3,0,2,5,2024,43.0
1369,1369,29,DNK,2,2,5,9,2024,26.0
1370,1370,30,AZE,2,2,3,7,2024,78.0
1371,1371,30,HRV,2,2,3,7,2024,53.0
1372,1372,32,CUB,2,1,6,9,2024,55.0
1373,1373,33,BHR,2,1,1,4,2024,61.0
1374,1374,34,SVN,2,1,0,3,2024,54.0
1375,1375,35,TWN,2,0,5,7,2024,70.0
1376,1376,36,AUT,2,0,3,5,2024,81.0
1377,1377,37,HKG,2,0,2,4,2024,67.0
1378,1378,37,PHL,2,0,2,4,2024,95.0
1379,1379,39,DZA,2,0,1,3,2024,130.0
1380,1380,39,IDN,2,0,1,3,2024,151.0
1381,1381,41,ISR,1,5,1,7,2024,138.0
1382,1382,42,POL,1,4,5,10,2024,76.0
1383,1383,43,KAZ,1,3,3,7,2024,4.0
1384,1384,44,JAM,1,3,2,6,2024,4.0
1385,1385,44,ZAF,1,3,2,6,2024,9.0
1386,1386,44,THA,1,3,2,6,2024,1.0
1387,1387,47,ETH,1,3,0,4,2024,39.0
1388,1388,48,CHE,1,2,5,8,2024,23.0
1389,1389,49,ECU,1,2,2,5,2024,17.0
1390,1390,50,PRT,1,2,1,4,2024,24.0
1391,1391,51,GRC,1,1,6,8,2024,96.0
1392,1392,52,ARG,1,1,1,3,2024,14.0
1393,1393,52,EGY,1,1,1,3,2024,56.0
1394,1394,52,TUN,1,1,1,3,2024,104.0
1395,1395,55,BWA,1,1,0,2,2024,26.0
1396,1396,55,CHL,1,1,0,2,2024,44.0
1397,1397,55,LCA,1,1,0,2,2024,18.0
1398,1398,55,UGA,1,1,0,2,2024,34.0
1399,1399,59,DOM,1,0,2,3,2024,37.0
1400,1400,60,GTM,1,0,1,2,2024,55.0
1401,1401,60,MAR,1,0,1,2,2024,57.0
1402,1402,62,DMA,1,0,0,1,2024,67.0
1403,1403,62,PAK,1,0,0,1,2024,76.0
1404,1404,64,TUR,0,3,5,8,2024,46.0
1405,1405,65,MEX,0,3,2,5,2024,60.0
1406,1406,66,ARM,0,3,1,4,2024,44.0
1407,1407,66,COL,0,3,1,4,2024,18.0
1408,1408,68,KGZ,0,2,4,6,2024,83.0
1409,1409,68,PRK,0,2,4,6,2024,25.0
1410,1410,70,LTU,0,2,2,4,2024,25.0
1411,1411,71,IND,0,1,5,6,2024,63.0
1412,1412,72,MDA,0,1,3,4,2024,35.0
1414,1414,74,CYP,0,1,0,1,2024,84.0
1415,1415,74,FJI,0,1,0,1,2024,59.0
1416,1416,74,JOR,0,1,0,1,2024,57.0
1417,1417,74,MNG,0,1,0,1,2024,55.0
1418,1418,74,PAN,0,1,0,1,2024,78.0
1419,1419,79,TJK,0,0,3,3,2024,77.0
1420,1420,80,ALB,0,0,2,2,2024,99.0
1421,1421,80,GRD,0,0,2,2,2024,76.0
1422,1422,80,MYS,0,0,2,2,2024,55.0
1423,1423,80,PRI,0,0,2,2,2024,63.0
1424,1424,84,CPV,0,0,1,1,2024,76.0
1425,1425,84,CIV,0,0,1,1,2024,93.0
1426,1426,84,PER,0,0,1,1,2024,150.0
1427,1427,84,QAT,0,0,1,1,2024,185.0
1428,1428,84,SGP,0,0,1,1,2024,13.0
1429,1429,84,SVK,0,0,1,1,2024,28.0
1430,1430,84,ZMB,0,0,1,1,2024,19.0
