Rank,NOC,Gold,Silver,Bronze,Total,Year,Participants,host_flag
1,USA,11,7,2,20,1896,27,0
2,GRC,10,18,19,47,1896,148,1
3,DEU,6,5,2,13,1896,94,0
4,FRA,5,4,2,11,1896,26,0
5,GBR,2,3,2,7,1896,25,0
6,HUN,2,1,3,6,1896,18,0
7,AUT,2,1,2,5,1896,8,0
8,AUS,2,0,0,2,1896,5,0
9,DNK,1,2,3,6,1896,15,0
10,CHE,1,2,0,3,1896,8,0
1,FRA,27,39,37,103,1900,1071,1
2,USA,19,14,15,48,1900,135,0
3,GBR,15,7,9,31,1900,146,0
5,BEL,6,7,4,17,1900,100,0
6,CHE,6,2,1,9,1900,52,0
7,DEU,4,3,2,9,1900,103,0
8,ITA,3,2,0,5,1900,36,0
9,AUS,2,0,3,5,1900,6,0
10,DNK,1,3,2,6,1900,36,0
11,HUN,1,2,2,5,1900,34,0
12,CUB,1,1,0,2,1900,2,0
13,CAN,1,0,1,2,1900,7,0
14,ESP,1,0,0,1,1900,12,0
14,LUX,1,0,0,1,1900,1,0
16,AUT,0,3,3,6,1900,26,0
17,NOR,0,2,3,5,1900,29,0
17,NLD,0,2,3,5,1900,73,0
19,IND,0,2,0,2,1900,5,0
21,SWE,0,0,1,1,1900,27,0
1,USA,76,78,77,231,1904,1109,1
2,DEU,4,5,6,15,1904,55,0
3,CAN,4,1,1,6,1904,61,0
4,CUB,3,0,0,3,1904,6,0
5,HUN,2,1,1,4,1904,9,0
7,NOR,2,0,0,2,1904,6,0
8,AUT,1,1,1,3,1904,7,0
9,GBR,1,1,0,2,1904,6,0
10,CHE,1,0,2,3,1904,7,0
11,GRC,1,0,1,2,1904,17,0
12,AUS,0,3,1,4,1904,6,0
13,FRA,0,1,0,1,1904,2,0
1,GBR,56,51,39,146,1908,972,1
2,USA,23,12,12,47,1908,219,0
3,SWE,8,6,11,25,1908,276,0
4,FRA,5,5,9,19,1908,319,0
5,DEU,3,5,5,13,1908,148,0
6,HUN,3,4,2,9,1908,107,0
7,CAN,3,3,10,16,1908,148,0
8,NOR,2,3,3,8,1908,103,0
9,ITA,2,2,0,4,1908,97,0
10,BEL,1,5,2,8,1908,99,0
11,AUS,1,2,2,5,1908,3,0
12,RUS,1,2,0,3,1908,7,0
13,FIN,1,1,3,5,1908,94,0
14,ZAF,1,1,0,2,1908,33,0
15,GRC,0,3,1,4,1908,49,0
16,DNK,0,2,3,5,1908,107,0
17,NLD,0,0,2,2,1908,218,0
19,AUT,0,0,1,1,1908,13,0
1,USA,26,19,19,64,1912,364,0
2,SWE,23,25,17,65,1912,714,1
3,GBR,10,15,16,41,1912,461,0
4,FIN,9,8,9,26,1912,233,0
5,FRA,7,4,3,14,1912,232,0
6,DEU,5,13,7,25,1912,312,0
7,ZAF,4,2,0,6,1912,56,0
8,NOR,3,2,5,10,1912,263,0
9,CAN,3,2,3,8,1912,60,0
9,HUN,3,2,3,8,1912,207,0
11,ITA,3,1,2,6,1912,96,0
12,AUS,2,2,3,7,1912,35,0
13,BEL,2,1,3,6,1912,72,0
14,DNK,1,6,5,12,1912,233,0
15,GRC,1,0,1,2,1912,77,0
16,RUS,0,2,3,5,1912,266,0
17,AUT,0,2,2,4,1912,132,0
18,NLD,0,0,3,3,1912,45,0
1,USA,41,27,27,95,1920,473,0
2,SWE,19,20,25,64,1920,404,0
3,FIN,15,10,9,34,1920,136,0
4,GBR,14,15,13,42,1920,345,0
5,BEL,14,11,11,36,1920,518,1
6,NOR,13,9,9,31,1920,267,0
7,ITA,13,5,5,23,1920,291,0
8,FRA,9,19,13,41,1920,452,0
9,NLD,4,2,5,11,1920,213,0
10,DNK,3,9,1,13,1920,246,0
11,ZAF,3,4,3,10,1920,97,0
12,CAN,3,3,3,9,1920,85,0
13,CHE,2,2,7,11,1920,126,0
14,EST,1,2,0,3,1920,20,0
15,BRA,1,1,1,3,1920,38,0
16,AUS,0,2,1,3,1920,29,0
17,JPN,0,2,0,2,1920,26,0
17,ESP,0,2,0,2,1920,111,0
19,GRC,0,1,0,1,1920,98,0
19,LUX,0,1,0,1,1920,35,0
22,NZL,0,0,1,1,1920,6,0
1,USA,45,27,27,99,1924,459,0
2,FIN,14,13,10,37,1924,253,0
3,FRA,13,15,10,38,1924,636,1
4,GBR,9,13,12,34,1924,428,0
5,ITA,8,3,5,16,1924,333,0
6,CHE,7,8,10,25,1924,262,0
7,NOR,5,2,3,10,1924,105,0
8,SWE,4,13,12,29,1924,256,0
9,NLD,4,1,5,10,1924,246,0
10,BEL,3,7,3,13,1924,234,0
11,AUS,3,1,2,6,1924,60,0
12,DNK,2,5,2,9,1924,158,0
13,HUN,2,3,4,9,1924,140,0
14,YUG,2,0,0,2,1924,116,0
16,ARG,1,3,2,6,1924,109,0
17,EST,1,1,4,6,1924,47,0
18,ZAF,1,1,1,3,1924,44,0
19,URY,1,0,0,1,1924,40,0
20,AUT,0,3,1,4,1924,56,0
20,CAN,0,3,1,4,1924,83,0
22,POL,0,1,1,2,1924,100,0
23,HTI,0,0,1,1,1924,16,0
23,JPN,0,0,1,1,1924,37,0
23,NZL,0,0,1,1,1924,6,0
23,PRT,0,0,1,1,1924,47,0
23,ROU,0,0,1,1,1924,45,0
1,USA,22,18,16,56,1928,426,0
2,DEU,10,7,14,31,1928,399,0
3,FIN,8,8,9,25,1928,132,0
4,SWE,7,6,12,25,1928,139,0
5,ITA,7,5,7,19,1928,273,0
6,CHE,7,4,4,15,1928,236,0
7,FRA,6,10,5,21,1928,422,0
8,NLD,6,9,4,19,1928,384,1
9,HUN,4,5,0,9,1928,219,0
10,CAN,4,4,7,15,1928,113,0
11,GBR,3,10,7,20,1928,354,0
12,ARG,3,3,1,7,1928,98,0
13,DNK,3,1,2,6,1928,122,0
15,JPN,2,2,1,5,1928,56,0
16,EST,2,1,2,5,1928,23,0
17,EGY,2,1,1,4,1928,43,0
18,AUT,2,0,1,3,1928,113,0
19,AUS,1,2,1,4,1928,29,0
19,NOR,1,2,1,4,1928,79,0
21,POL,1,1,3,5,1928,146,0
21,YUG,1,1,3,5,1928,86,0
23,ZAF,1,0,2,3,1928,40,0
24,IND,1,0,0,1,1928,24,0
24,IRL,1,0,0,1,1928,44,0
24,NZL,1,0,0,1,1928,13,0
24,ESP,1,0,0,1,1928,106,0
24,URY,1,0,0,1,1928,17,0
29,BEL,0,1,2,3,1928,260,0
30,CHL,0,1,0,1,1928,46,0
30,HTI,0,1,0,1,1928,3,0
32,PHL,0,0,1,1,1928,6,0
32,PRT,0,0,1,1,1928,39,0
1,USA,44,36,30,110,1932,743,1
2,ITA,12,12,12,36,1932,154,0
3,FRA,11,5,4,20,1932,159,0
4,SWE,10,5,9,24,1932,128,0
5,JPN,7,7,4,18,1932,203,0
6,HUN,6,5,5,16,1932,118,0
7,DEU,5,12,7,24,1932,202,0
8,FIN,5,8,12,25,1932,66,0
9,GBR,5,7,5,17,1932,170,0
10,POL,3,2,4,9,1932,71,0
11,AUS,3,1,1,5,1932,20,0
12,ARG,3,1,0,4,1932,47,0
13,CAN,2,5,9,16,1932,191,0
14,NLD,2,5,1,8,1932,80,0
15,ZAF,2,0,3,5,1932,20,0
16,IRL,2,0,0,2,1932,18,0
18,AUT,1,1,3,5,1932,33,0
19,IND,1,0,0,1,1932,26,0
20,DNK,0,5,3,8,1932,94,0
21,MEX,0,2,0,2,1932,100,0
22,LVA,0,1,0,1,1932,13,0
22,NZL,0,1,0,1,1932,29,0
22,CHE,0,1,0,1,1932,9,0
25,PHL,0,0,3,3,1932,8,0
26,BEL,0,0,1,1,1932,69,0
26,ESP,0,0,1,1,1932,8,0
26,URY,0,0,1,1,1932,6,0
1,DEU,38,31,32,101,1936,581,1
2,USA,24,21,12,57,1936,487,0
3,HUN,10,1,5,16,1936,335,0
4,ITA,9,13,5,27,1936,349,0
5,FIN,8,6,6,20,1936,186,0
6,FRA,7,6,6,19,1936,303,0
7,SWE,6,5,10,21,1936,231,0
8,JPN,6,4,10,20,1936,325,0
9,NLD,6,4,7,17,1936,227,0
10,AUT,5,7,5,17,1936,363,0
11,CHE,4,9,5,18,1936,328,0
12,GBR,4,7,3,14,1936,250,0
14,ARG,2,2,3,7,1936,68,0
14,EST,2,2,3,7,1936,36,0
16,EGY,2,1,2,5,1936,66,0
17,CAN,1,3,5,9,1936,167,0
18,NOR,1,3,2,6,1936,84,0
19,TUR,1,0,1,2,1936,62,0
20,IND,1,0,0,1,1936,30,0
20,NZL,1,0,0,1,1936,9,0
22,POL,0,4,5,9,1936,177,0
23,DNK,0,2,3,5,1936,173,0
24,LVA,0,1,1,2,1936,33,0
25,ROU,0,1,0,1,1936,118,0
25,ZAF,0,1,0,1,1936,54,0
25,YUG,0,1,0,1,1936,173,0
28,BEL,0,0,3,3,1936,205,0
28,MEX,0,0,3,3,1936,32,0
30,AUS,0,0,1,1,1936,39,0
30,PHL,0,0,1,1,1936,40,0
30,PRT,0,0,1,1,1936,26,0
1,USA,38,27,19,84,1948,424,0
2,SWE,16,11,17,44,1948,223,0
3,FRA,10,6,13,29,1948,433,0
4,HUN,10,5,12,27,1948,222,0
5,ITA,8,11,8,27,1948,310,0
6,FIN,8,7,5,20,1948,215,0
7,TUR,6,4,2,12,1948,87,0
9,CHE,5,10,5,20,1948,287,0
10,DNK,5,7,8,20,1948,253,0
11,NLD,5,2,9,16,1948,187,0
12,GBR,3,14,6,23,1948,590,1
13,ARG,3,3,1,7,1948,295,0
14,AUS,2,6,5,13,1948,103,0
15,BEL,2,2,3,7,1948,182,0
16,EGY,2,2,1,5,1948,166,0
17,MEX,2,1,2,5,1948,149,0
18,ZAF,2,1,1,4,1948,43,0
19,NOR,1,3,3,7,1948,97,0
20,JAM,1,2,0,3,1948,26,0
21,AUT,1,0,3,4,1948,239,0
22,IND,1,0,0,1,1948,89,0
22,PER,1,0,0,1,1948,49,0
24,YUG,0,2,0,2,1948,162,0
25,CAN,0,1,2,3,1948,188,0
26,PRT,0,1,1,2,1948,65,0
26,URY,0,1,1,2,1948,79,0
28,CUB,0,1,0,1,1948,112,0
28,ESP,0,1,0,1,1948,84,0
28,TTO,0,1,0,1,1948,9,0
32,PAN,0,0,2,2,1948,2,0
32,KOR,0,0,2,2,1948,48,0
34,BRA,0,0,1,1,1948,105,0
34,IRN,0,0,1,1,1948,39,0
34,POL,0,0,1,1,1948,52,0
34,PRI,0,0,1,1,1948,9,0
1,USA,40,19,17,76,1952,451,0
3,HUN,16,10,16,42,1952,345,0
4,SWE,12,13,10,35,1952,355,0
5,ITA,8,9,4,21,1952,376,0
7,FRA,6,6,6,18,1952,408,0
8,FIN,6,3,13,22,1952,412,1
9,AUS,6,2,3,11,1952,140,0
10,NOR,3,2,0,5,1952,190,0
11,CHE,2,6,6,14,1952,251,0
12,ZAF,2,4,4,10,1952,109,0
13,JAM,2,3,0,5,1952,16,0
14,BEL,2,2,0,4,1952,184,0
15,DNK,2,1,3,6,1952,201,0
16,TUR,2,0,1,3,1952,58,0
17,JPN,1,6,2,9,1952,133,0
18,GBR,1,2,8,11,1952,401,0
19,ARG,1,2,2,5,1952,174,0
20,POL,1,2,1,4,1952,248,0
21,CAN,1,2,0,3,1952,154,0
21,YUG,1,2,0,3,1952,194,0
23,ROU,1,1,2,4,1952,241,0
24,BRA,1,0,2,3,1952,119,0
24,NZL,1,0,2,3,1952,20,0
26,IND,1,0,1,2,1952,94,0
27,LUX,1,0,0,1,1952,101,0
28,DEU,0,7,17,24,1952,365,0
29,NLD,0,5,0,5,1952,180,0
30,IRN,0,3,4,7,1952,23,0
31,CHL,0,2,0,2,1952,82,0
32,AUT,0,1,1,2,1952,238,0
32,LBN,0,1,1,2,1952,240,0
34,IRL,0,1,0,1,1952,25,0
34,MEX,0,1,0,1,1952,85,0
34,ESP,0,1,0,1,1952,42,0
37,KOR,0,0,2,2,1952,22,0
37,TTO,0,0,2,2,1952,2,0
37,URY,0,0,2,2,1952,42,0
40,BGR,0,0,1,1,1952,179,0
40,EGY,0,0,1,1,1952,196,0
40,PRT,0,0,1,1,1952,155,0
40,VEN,0,0,1,1,1952,63,0
2,USA,32,25,17,74,1956,443,0
3,AUS,13,8,14,35,1956,412,1
4,HUN,9,10,7,26,1956,197,0
5,ITA,8,8,9,25,1956,207,0
6,SWE,8,5,6,19,1956,186,0
7,DEU,6,13,7,26,1956,261,0
8,GBR,6,7,11,24,1956,283,0
9,ROU,5,3,5,13,1956,103,0
10,JPN,4,10,5,19,1956,222,0
11,FRA,4,4,6,14,1956,227,0
12,TUR,3,2,2,7,1956,28,0
13,FIN,3,1,11,15,1956,147,0
14,IRN,2,2,1,5,1956,17,0
15,CAN,2,1,3,6,1956,150,0
16,NZL,2,0,0,2,1956,57,0
17,POL,1,4,4,9,1956,118,0
19,BGR,1,3,1,5,1956,82,0
20,DNK,1,2,1,4,1956,51,0
21,IRL,1,1,3,5,1956,25,0
22,NOR,1,0,2,3,1956,29,0
23,MEX,1,0,1,2,1956,36,0
24,BRA,1,0,0,1,1956,63,0
24,IND,1,0,0,1,1956,79,0
26,YUG,0,3,0,3,1956,37,0
27,CHL,0,2,2,4,1956,43,0
28,BEL,0,2,0,2,1956,82,0
29,ARG,0,1,1,2,1956,44,0
29,KOR,0,1,1,2,1956,36,0
31,ISL,0,1,0,1,1956,2,0
31,PAK,0,1,0,1,1956,79,0
33,ZAF,0,0,4,4,1956,90,0
34,AUT,0,0,2,2,1956,57,0
35,BHS,0,0,1,1,1956,5,0
35,GRC,0,0,1,1,1956,16,0
35,CHE,0,0,1,1,1956,18,0
35,URY,0,0,1,1,1956,29,0
2,USA,34,21,16,71,1960,428,0
3,ITA,13,10,13,36,1960,402,1
4,DEU,12,19,11,42,1960,425,0
5,AUS,8,8,6,22,1960,280,0
6,TUR,7,2,0,9,1960,58,0
7,HUN,6,8,7,21,1960,312,0
8,JPN,4,7,7,18,1960,278,0
9,POL,4,6,11,21,1960,307,0
11,ROU,3,1,6,10,1960,156,0
12,GBR,2,6,12,20,1960,389,0
13,DNK,2,3,1,6,1960,109,0
14,NZL,2,0,1,3,1960,47,0
15,BGR,1,3,3,7,1960,183,0
16,SWE,1,2,3,6,1960,258,0
17,FIN,1,1,3,5,1960,219,0
18,AUT,1,1,0,2,1960,198,0
18,YUG,1,1,0,2,1960,185,0
20,PAK,1,0,1,2,1960,53,0
21,ETH,1,0,0,1,1960,15,0
21,GRC,1,0,0,1,1960,59,0
21,NOR,1,0,0,1,1960,50,0
24,CHE,0,3,3,6,1960,221,0
25,FRA,0,2,3,5,1960,363,0
26,BEL,0,2,2,4,1960,150,0
27,IRN,0,1,3,4,1960,24,0
28,NLD,0,1,2,3,1960,160,0
28,ZAF,0,1,2,3,1960,72,0
30,ARG,0,1,1,2,1960,116,0
30,EGY,0,1,1,2,1960,2,0
32,CAN,0,1,0,1,1960,140,0
32,TWN,0,1,0,1,1960,31,0
32,GHA,0,1,0,1,1960,15,0
32,IND,0,1,0,1,1960,49,0
32,MAR,0,1,0,1,1960,111,0
32,PRT,0,1,0,1,1960,109,0
32,SGP,0,1,0,1,1960,5,0
39,BRA,0,0,2,2,1960,86,0
39,IND,0,0,2,2,1960,49,0
41,IRQ,0,0,1,1,1960,28,0
41,MEX,0,0,1,1,1960,110,0
41,ESP,0,0,1,1,1960,238,0
41,VEN,0,0,1,1,1960,54,0
1,USA,36,26,28,90,1964,492,0
3,JPN,16,5,8,29,1964,456,1
4,DEU,10,22,18,50,1964,478,0
5,ITA,10,10,7,27,1964,256,0
6,HUN,10,7,5,22,1964,319,0
7,POL,7,6,10,23,1964,240,0
8,AUS,6,2,10,18,1964,392,0
10,GBR,4,12,2,18,1964,301,0
11,BGR,3,5,2,10,1964,116,0
12,FIN,3,0,2,5,1964,151,0
12,NZL,3,0,2,5,1964,88,0
14,ROU,2,4,6,12,1964,232,0
15,NLD,2,4,4,10,1964,158,0
16,TUR,2,3,1,6,1964,25,0
17,SWE,2,2,4,8,1964,175,0
18,DNK,2,1,3,6,1964,71,0
19,YUG,2,1,2,5,1964,123,0
20,BEL,2,0,1,3,1964,74,0
21,FRA,1,8,6,15,1964,214,0
22,CAN,1,2,1,4,1964,194,0
22,CHE,1,2,1,4,1964,129,0
24,BHS,1,0,0,1,1964,12,0
24,ETH,1,0,0,1,1964,19,0
24,IND,1,0,0,1,1964,111,0
27,KOR,0,2,1,3,1964,240,0
28,TTO,0,1,2,3,1964,18,0
29,TUN,0,1,1,2,1964,12,0
30,ARG,0,1,0,1,1964,148,0
30,CUB,0,1,0,1,1964,76,0
30,PAK,0,1,0,1,1964,47,0
30,PHL,0,1,0,1,1964,70,0
34,IRN,0,0,2,2,1964,96,0
35,BRA,0,0,1,1,1964,65,0
35,GHA,0,0,1,1,1964,40,0
35,IRL,0,0,1,1,1964,35,0
35,KEN,0,0,1,1,1964,41,0
35,MEX,0,0,1,1,1964,128,0
35,NGA,0,0,1,1,1964,19,0
35,URY,0,0,1,1,1964,29,0
1,USA,45,28,34,107,1968,529,0
3,JPN,11,7,7,25,1968,289,0
4,HUN,10,10,12,32,1968,303,0
5,DDR,9,9,7,25,1968,346,0
6,FRA,7,3,5,15,1968,311,0
8,DEU,5,11,10,26,1968,33,0
9,AUS,5,7,5,17,1968,224,0
10,GBR,5,5,3,13,1968,328,0
11,POL,5,2,11,18,1968,296,0
12,ROU,4,6,5,15,1968,100,0
13,ITA,3,4,9,16,1968,268,0
14,KEN,3,4,2,9,1968,50,0
15,MEX,3,3,3,9,1968,446,1
16,YUG,3,3,2,8,1968,130,0
17,NLD,3,3,1,7,1968,140,0
18,BGR,2,4,3,9,1968,189,0
19,IRN,2,1,2,5,1968,14,0
20,SWE,2,1,1,4,1968,186,0
21,TUR,2,0,0,2,1968,30,0
22,DNK,1,4,3,8,1968,93,0
23,CAN,1,3,1,5,1968,291,0
24,FIN,1,2,1,4,1968,126,0
25,ETH,1,1,0,2,1968,26,0
25,NOR,1,1,0,2,1968,86,0
27,NZL,1,0,2,3,1968,65,0
28,TUN,1,0,1,2,1968,8,0
29,PAK,1,0,0,1,1968,15,0
29,VEN,1,0,0,1,1968,30,0
31,CUB,0,4,0,4,1968,227,0
32,AUT,0,2,2,4,1968,59,0
33,CHE,0,1,4,5,1968,155,0
34,MNG,0,1,3,4,1968,38,0
35,BRA,0,1,2,3,1968,89,0
36,BEL,0,1,1,2,1968,106,0
36,KOR,0,1,1,2,1968,66,0
36,UGA,0,1,1,2,1968,14,0
39,CMR,0,1,0,1,1968,5,0
39,JAM,0,1,0,1,1968,35,0
41,ARG,0,0,2,2,1968,132,0
42,GRC,0,0,1,1,1968,44,0
42,IND,0,0,1,1,1968,27,0
42,TWN,0,0,1,1,1968,93,0
2,USA,33,31,30,94,1972,578,0
3,DDR,20,23,23,66,1972,454,0
4,DEU,13,11,16,40,1972,8,1
5,JPN,13,8,8,29,1972,293,0
6,AUS,8,7,2,17,1972,266,0
7,POL,7,5,9,21,1972,418,0
8,HUN,6,13,16,35,1972,367,0
9,BGR,6,10,5,21,1972,226,0
10,ITA,5,3,10,18,1972,345,0
11,SWE,4,6,6,16,1972,186,0
12,GBR,4,5,9,18,1972,433,0
13,ROU,3,6,7,16,1972,258,0
14,CUB,3,1,4,8,1972,201,0
14,FIN,3,1,4,8,1972,133,0
16,NLD,3,1,1,5,1972,199,0
17,FRA,2,4,7,13,1972,356,0
19,KEN,2,3,4,9,1972,69,0
20,YUG,2,1,2,5,1972,212,0
21,NOR,2,1,1,4,1972,161,0
22,PRK,1,1,3,5,1972,83,0
23,NZL,1,1,1,3,1972,112,0
24,UGA,1,1,0,2,1972,35,0
25,DNK,1,0,0,1,1972,155,0
26,CHE,0,3,0,3,1972,265,0
27,CAN,0,2,3,5,1972,344,0
28,IRN,0,2,1,3,1972,56,0
29,BEL,0,2,0,2,1972,106,0
29,GRC,0,2,0,2,1972,66,0
31,AUT,0,1,2,3,1972,143,0
31,COL,0,1,2,3,1972,75,0
33,ARG,0,1,0,1,1972,123,0
33,LBN,0,1,0,1,1972,85,0
33,MEX,0,1,0,1,1972,281,0
33,MNG,0,1,0,1,1972,44,0
33,PAK,0,1,0,1,1972,26,0
33,KOR,0,1,0,1,1972,43,0
33,TUN,0,1,0,1,1972,37,0
33,TUR,0,1,0,1,1972,50,0
41,BRA,0,0,2,2,1972,104,0
41,ETH,0,0,2,2,1972,40,0
43,GHA,0,0,1,1,1972,41,0
43,IND,0,0,1,1,1972,43,0
43,JAM,0,0,1,1,1972,51,0
43,NER,0,0,1,1,1972,4,0
43,NGA,0,0,1,1,1972,36,0
43,ESP,0,0,1,1,1972,162,0
2,DDR,40,25,25,90,1976,407,0
3,USA,34,35,25,94,1976,554,0
4,DEU,10,12,17,39,1976,391,0
5,JPN,9,6,10,25,1976,328,0
6,POL,7,6,13,26,1976,286,0
7,BGR,6,9,7,22,1976,254,0
8,CUB,6,4,3,13,1976,194,0
9,ROU,4,9,14,27,1976,255,0
10,HUN,4,5,13,22,1976,288,0
11,FIN,4,2,0,6,1976,108,0
12,SWE,4,1,0,5,1976,163,0
13,GBR,3,5,5,13,1976,353,0
14,ITA,2,7,4,13,1976,312,0
15,FRA,2,3,4,9,1976,302,0
16,YUG,2,3,3,8,1976,95,0
18,NZL,2,1,1,4,1976,98,0
19,KOR,1,1,4,6,1976,51,0
20,CHE,1,1,2,4,1976,101,0
21,JAM,1,1,0,2,1976,36,0
21,PRK,1,1,0,2,1976,40,0
21,NOR,1,1,0,2,1976,79,0
24,DNK,1,0,2,3,1976,81,0
25,MEX,1,0,1,2,1976,137,0
26,TTO,1,0,0,1,1976,20,0
27,CAN,0,5,6,11,1976,531,1
28,BEL,0,3,3,6,1976,149,0
29,NLD,0,2,3,5,1976,175,0
30,PRT,0,2,0,2,1976,36,0
30,ESP,0,2,0,2,1976,160,0
32,AUS,0,1,4,5,1976,274,0
33,IRN,0,1,1,2,1976,104,0
34,MNG,0,1,0,1,1976,33,0
34,VEN,0,1,0,1,1976,56,0
36,BRA,0,0,2,2,1976,89,0
37,AUT,0,0,1,1,1976,73,0
37,BMU,0,0,1,1,1976,20,0
37,PAK,0,0,1,1,1976,24,0
37,PRI,0,0,1,1,1976,112,0
37,THA,0,0,1,1,1976,62,0
2,DDR,47,37,42,126,1980,495,0
3,BGR,8,16,17,41,1980,397,0
4,CUB,8,7,5,20,1980,288,0
5,ITA,8,3,4,15,1980,203,0
6,HUN,7,10,15,32,1980,392,0
7,ROU,6,6,13,25,1980,339,0
8,FRA,6,5,3,14,1980,200,0
9,GBR,5,7,9,21,1980,328,0
10,POL,3,14,15,32,1980,418,0
11,SWE,3,3,6,12,1980,201,0
12,FIN,3,1,4,8,1980,125,0
14,YUG,2,3,4,9,1980,180,0
15,AUS,2,2,5,9,1980,190,0
16,DNK,2,1,2,5,1980,60,0
17,BRA,2,0,2,4,1980,149,0
17,ETH,2,0,2,4,1980,48,0
19,CHE,2,0,0,2,1980,86,0
20,ESP,1,3,2,6,1980,211,0
21,AUT,1,2,1,4,1980,92,0
22,GRC,1,0,2,3,1980,45,0
23,BEL,1,0,0,1,1980,84,0
23,IND,1,0,0,1,1980,78,0
23,ZWE,1,0,0,1,1980,52,0
26,PRK,0,3,2,5,1980,121,0
27,MNG,0,2,2,4,1980,57,0
28,TZA,0,2,0,2,1980,48,0
29,MEX,0,1,3,4,1980,74,0
30,NLD,0,1,2,3,1980,112,0
31,IRL,0,1,1,2,1980,57,0
32,UGA,0,1,0,1,1980,16,0
32,VEN,0,1,0,1,1980,43,0
34,JAM,0,0,3,3,1980,32,0
35,GUY,0,0,1,1,1980,10,0
35,LBN,0,0,1,1,1980,1,0
1,USA,83,61,30,174,1984,693,1
2,ROU,20,16,17,53,1984,193,0
3,DEU,17,19,23,59,1984,394,0
4,CHN,15,8,9,32,1984,323,0
5,ITA,14,6,12,32,1984,368,0
6,CAN,10,18,16,44,1984,572,0
7,JPN,10,8,14,32,1984,365,0
8,NZL,8,1,2,11,1984,162,0
9,YUG,7,4,7,18,1984,154,0
10,KOR,6,6,7,19,1984,240,0
11,GBR,5,11,21,37,1984,509,0
12,FRA,5,7,16,28,1984,354,0
13,NLD,5,2,6,13,1984,185,0
14,AUS,4,8,12,24,1984,337,0
15,FIN,4,2,6,12,1984,107,0
16,SWE,2,11,6,19,1984,254,0
17,MEX,2,3,1,6,1984,155,0
18,MAR,2,0,0,2,1984,35,0
19,BRA,1,5,2,8,1984,197,0
20,ESP,1,2,2,5,1984,257,0
21,BEL,1,1,2,4,1984,86,0
22,AUT,1,1,1,3,1984,130,0
23,KEN,1,0,2,3,1984,67,0
23,PRT,1,0,2,3,1984,48,0
25,PAK,1,0,0,1,1984,33,0
26,CHE,0,4,4,8,1984,245,0
27,DNK,0,3,3,6,1984,74,0
28,JAM,0,1,2,3,1984,75,0
28,NOR,0,1,2,3,1984,132,0
30,GRC,0,1,1,2,1984,73,0
30,NGA,0,1,1,2,1984,36,0
30,PRI,0,1,1,2,1984,58,0
33,COL,0,1,0,1,1984,48,0
33,EGY,0,1,0,1,1984,148,0
33,IRL,0,1,0,1,1984,55,0
33,CIV,0,1,0,1,1984,18,0
33,PER,0,1,0,1,1984,44,0
33,SYR,0,1,0,1,1984,9,0
33,THA,0,1,0,1,1984,40,0
40,TUR,0,0,3,3,1984,62,0
40,VEN,0,0,3,3,1984,44,0
42,DZA,0,0,2,2,1984,33,0
43,CMR,0,0,1,1,1984,56,0
43,TWN,0,0,1,1,1984,52,0
43,DOM,0,0,1,1,1984,24,0
43,ISL,0,0,1,1,1984,35,0
43,ZMB,0,0,1,1,1984,18,0
2,DDR,37,35,30,102,1988,402,0
3,USA,36,31,27,94,1988,715,0
4,KOR,12,10,11,33,1988,551,1
5,DEU,11,14,15,40,1988,4,0
6,HUN,11,6,6,23,1988,315,0
7,BGR,10,12,13,35,1988,281,0
8,ROU,7,11,6,24,1988,172,0
9,FRA,6,4,6,16,1988,413,0
10,ITA,6,4,4,14,1988,374,0
11,CHN,5,11,12,28,1988,427,0
12,GBR,5,10,9,24,1988,472,0
13,KEN,5,2,2,9,1988,88,0
14,JPN,4,3,7,14,1988,412,0
15,AUS,3,6,5,14,1988,339,0
16,YUG,3,4,5,12,1988,183,0
18,NZL,3,2,8,13,1988,112,0
19,CAN,3,2,5,10,1988,503,0
20,POL,2,5,9,16,1988,192,0
21,NOR,2,3,0,5,1988,79,0
22,NLD,2,2,5,9,1988,202,0
23,DNK,2,1,1,4,1988,130,0
24,BRA,1,2,3,6,1988,233,0
25,FIN,1,1,2,4,1988,101,0
25,ESP,1,1,2,4,1988,317,0
27,TUR,1,1,0,2,1988,51,0
28,MAR,1,0,2,3,1988,29,0
29,AUT,1,0,0,1,1988,96,0
29,PRT,1,0,0,1,1988,91,0
29,SUR,1,0,0,1,1988,10,0
32,SWE,0,4,7,11,1988,251,0
33,CHE,0,2,2,4,1988,151,0
34,JAM,0,2,0,2,1988,49,0
35,ARG,0,1,1,2,1988,134,0
36,CHL,0,1,0,1,1988,23,0
36,CRI,0,1,0,1,1988,33,0
36,IDN,0,1,0,1,1988,43,0
36,IRN,0,1,0,1,1988,26,0
36,PER,0,1,0,1,1988,26,0
36,SEN,0,1,0,1,1988,35,0
36,VGB,0,1,0,1,1988,4,0
44,BEL,0,0,2,2,1988,85,0
44,MEX,0,0,2,2,1988,144,0
46,COL,0,0,1,1,1988,57,0
46,DJI,0,0,1,1,1988,6,0
46,GRC,0,0,1,1,1988,72,0
46,MNG,0,0,1,1,1988,32,0
46,PAK,0,0,1,1,1988,33,0
46,PHL,0,0,1,1,1988,42,0
46,THA,0,0,1,1,1988,15,0
2,USA,37,34,37,108,1992,734,0
3,DEU,33,21,28,82,1992,653,0
4,CHN,16,22,16,54,1992,394,0
5,CUB,14,6,11,31,1992,196,0
6,ESP,13,7,2,22,1992,537,1
7,KOR,12,5,12,29,1992,322,0
8,HUN,11,12,7,30,1992,351,0
9,FRA,8,5,16,29,1992,486,0
10,AUS,7,9,11,27,1992,390,0
11,CAN,7,4,7,18,1992,445,0
12,ITA,6,5,8,19,1992,431,0
13,GBR,5,3,12,20,1992,512,0
14,ROU,4,6,8,18,1992,306,0
16,PRK,4,0,5,9,1992,123,0
17,JPN,3,8,11,22,1992,392,0
18,BGR,3,7,6,16,1992,236,0
19,POL,3,6,10,19,1992,263,0
20,NLD,2,6,7,15,1992,257,0
21,KEN,2,4,2,8,1992,55,0
22,NOR,2,4,1,7,1992,114,0
23,TUR,2,2,2,6,1992,54,0
24,IDN,2,2,1,5,1992,51,0
25,BRA,2,1,0,3,1992,233,0
26,GRC,2,0,0,2,1992,76,0
27,SWE,1,7,4,12,1992,252,0
28,NZL,1,4,5,10,1992,175,0
29,FIN,1,2,2,5,1992,130,0
30,DNK,1,1,4,6,1992,144,0
31,MAR,1,1,1,3,1992,45,0
32,IRL,1,1,0,2,1992,77,0
33,ETH,1,0,2,3,1992,24,0
34,DZA,1,0,1,2,1992,36,0
34,EST,1,0,1,2,1992,46,0
34,LTU,1,0,1,2,1992,54,0
37,CHE,1,0,0,1,1992,171,0
38,JAM,0,3,1,4,1992,51,0
38,NGA,0,3,1,4,1992,72,0
40,LVA,0,2,1,3,1992,40,0
41,AUT,0,2,0,2,1992,127,0
41,NAM,0,2,0,2,1992,10,0
41,ZAF,0,2,0,2,1992,141,0
44,BEL,0,1,2,3,1992,103,0
44,HRV,0,1,2,3,1992,46,0
44,IRN,0,1,2,3,1992,44,0
48,ISR,0,1,1,2,1992,44,0
49,TWN,0,1,0,1,1992,38,0
49,MEX,0,1,0,1,1992,140,0
49,PER,0,1,0,1,1992,21,0
52,MNG,0,0,2,2,1992,38,0
52,SVN,0,0,2,2,1992,47,0
54,ARG,0,0,1,1,1992,111,0
54,BHS,0,0,1,1,1992,18,0
54,COL,0,0,1,1,1992,61,0
54,GHA,0,0,1,1,1992,41,0
54,MYS,0,0,1,1,1992,30,0
54,PAK,0,0,1,1,1992,28,0
54,PHL,0,0,1,1,1992,38,0
54,PRI,0,0,1,1,1992,101,0
54,QAT,0,0,1,1,1992,30,0
54,SUR,0,0,1,1,1992,9,0
54,THA,0,0,1,1,1992,64,0
1,USA,44,32,25,101,1996,839,1
2,RUS,26,21,16,63,1996,552,0
3,DEU,20,18,27,65,1996,626,0
4,CHN,16,22,12,50,1996,438,0
5,FRA,15,7,15,37,1996,453,0
6,ITA,13,10,12,35,1996,460,0
7,AUS,9,9,23,41,1996,550,0
8,CUB,9,8,8,25,1996,178,0
9,UKR,9,2,12,23,1996,351,0
10,KOR,7,15,5,27,1996,417,0
11,POL,7,5,5,17,1996,207,0
12,HUN,7,4,10,21,1996,315,0
13,ESP,5,6,6,17,1996,384,0
14,ROU,4,7,9,20,1996,284,0
15,NLD,4,5,10,19,1996,290,0
16,GRC,4,4,0,8,1996,180,0
17,CZE,4,3,4,11,1996,169,0
18,CHE,4,3,0,7,1996,172,0
19,DNK,4,1,1,6,1996,145,0
19,TUR,4,1,1,6,1996,61,0
21,CAN,3,11,8,22,1996,408,0
22,BGR,3,7,5,15,1996,181,0
23,JPN,3,6,5,14,1996,448,0
24,KAZ,3,4,4,11,1996,142,0
25,BRA,3,3,9,15,1996,251,0
26,NZL,3,2,1,6,1996,129,0
27,ZAF,3,1,1,5,1996,111,0
28,IRL,3,0,1,4,1996,99,0
29,SWE,2,4,2,8,1996,233,0
30,NOR,2,2,3,7,1996,116,0
31,BEL,2,2,2,6,1996,81,0
32,NGA,2,1,3,6,1996,84,0
33,PRK,2,1,2,5,1996,36,0
34,DZA,2,0,1,3,1996,47,0
34,ETH,2,0,1,3,1996,19,0
36,GBR,1,8,6,15,1996,391,0
37,BLR,1,6,8,15,1996,259,0
38,KEN,1,4,3,8,1996,54,0
39,JAM,1,3,2,6,1996,69,0
40,FIN,1,2,1,4,1996,105,0
41,YUG,1,1,2,4,1996,161,0
41,IDN,1,1,2,4,1996,45,0
43,IRN,1,1,1,3,1996,18,0
43,SVK,1,1,1,3,1996,98,0
45,ARM,1,1,0,2,1996,38,0
45,HRV,1,1,0,2,1996,117,0
47,PRT,1,0,1,2,1996,131,0
47,THA,1,0,1,2,1996,58,0
49,BDI,1,0,0,1,1996,7,0
49,CRI,1,0,0,1,1996,13,0
49,ECU,1,0,0,1,1996,28,0
49,HKG,1,0,0,1,1996,32,0
49,SYR,1,0,0,1,1996,8,0
54,ARG,0,2,1,3,1996,221,0
55,NAM,0,2,0,2,1996,10,0
55,SVN,0,2,0,2,1996,47,0
57,AUT,0,1,2,3,1996,92,0
58,MYS,0,1,1,2,1996,43,0
58,MDA,0,1,1,2,1996,50,0
58,UZB,0,1,1,2,1996,95,0
61,AZE,0,1,0,1,1996,24,0
61,BHS,0,1,0,1,1996,36,0
61,TWN,0,1,0,1,1996,107,0
61,LVA,0,1,0,1,1996,55,0
61,PHL,0,1,0,1,1996,18,0
61,TON,0,1,0,1,1996,5,0
61,ZMB,0,1,0,1,1996,8,0
68,GEO,0,0,2,2,1996,42,0
68,MAR,0,0,2,2,1996,38,0
68,TTO,0,0,2,2,1996,16,0
71,IND,0,0,1,1,1996,54,0
71,ISR,0,0,1,1,1996,38,0
71,LTU,0,0,1,1,1996,81,0
71,MEX,0,0,1,1,1996,111,0
71,MNG,0,0,1,1,1996,18,0
71,MOZ,0,0,1,1,1996,3,0
71,PRI,0,0,1,1,1996,91,0
71,TUN,0,0,1,1,1996,52,0
71,UGA,0,0,1,1,1996,12,0
1,USA,37,24,32,93,2000,764,0
2,RUS,32,28,29,89,2000,602,0
3,CHN,28,16,14,58,2000,414,0
4,AUS,16,25,17,58,2000,788,1
5,DEU,13,17,26,56,2000,567,0
6,FRA,13,14,11,38,2000,470,0
7,ITA,13,8,13,34,2000,457,0
8,NLD,12,9,4,25,2000,285,0
9,CUB,11,11,7,29,2000,271,0
10,GBR,11,10,7,28,2000,415,0
11,ROU,11,6,9,26,2000,252,0
12,KOR,8,10,10,28,2000,359,0
13,HUN,8,6,3,17,2000,238,0
14,POL,6,5,3,14,2000,240,0
15,JPN,5,8,5,18,2000,363,0
16,BGR,5,6,2,13,2000,150,0
17,GRC,4,6,3,13,2000,175,0
18,SWE,4,5,3,12,2000,198,0
19,NOR,4,3,3,10,2000,115,0
20,ETH,4,1,3,8,2000,27,0
21,UKR,3,10,10,23,2000,368,0
22,KAZ,3,4,0,7,2000,158,0
23,BLR,3,3,11,17,2000,231,0
24,CAN,3,3,8,14,2000,422,0
25,ESP,3,3,5,11,2000,431,0
26,TUR,3,0,2,5,2000,67,0
27,IRN,3,0,1,4,2000,34,0
28,CZE,2,3,3,8,2000,162,0
29,KEN,2,3,2,7,2000,59,0
30,DNK,2,3,1,6,2000,124,0
31,FIN,2,1,1,4,2000,88,0
32,AUT,2,1,0,3,2000,114,0
33,LTU,2,0,3,5,2000,77,0
34,AZE,2,0,1,3,2000,32,0
34,BHS,2,0,1,3,2000,39,0
36,SVN,2,0,0,2,2000,90,0
37,CHE,1,6,2,9,2000,138,0
38,IDN,1,3,2,6,2000,54,0
39,SVK,1,3,1,5,2000,132,0
40,MEX,1,2,3,6,2000,98,0
41,NGA,1,2,0,3,2000,100,0
42,DZA,1,1,3,5,2000,51,0
43,UZB,1,1,2,4,2000,85,0
44,YUG,1,1,1,3,2000,12,0
44,LVA,1,1,1,3,2000,60,0
46,NZL,1,0,3,4,2000,177,0
47,EST,1,0,2,3,2000,41,0
47,THA,1,0,2,3,2000,68,0
49,HRV,1,0,1,2,2000,108,0
50,CMR,1,0,0,1,2000,39,0
50,COL,1,0,0,1,2000,54,0
50,MOZ,1,0,0,1,2000,4,0
53,BRA,0,6,6,12,2000,236,0
54,JAM,0,6,3,9,2000,65,0
55,BEL,0,2,3,5,2000,94,0
55,ZAF,0,2,3,5,2000,161,0
57,ARG,0,2,2,4,2000,165,0
58,TWN,0,1,4,5,2000,75,0
58,MAR,0,1,4,5,2000,55,0
60,PRK,0,1,3,4,2000,47,0
61,MDA,0,1,1,2,2000,35,0
61,SAU,0,1,1,2,2000,23,0
61,TTO,0,1,1,2,2000,29,0
64,IRL,0,1,0,1,2000,76,0
64,LKA,0,1,0,1,2000,24,0
64,URY,0,1,0,1,2000,17,0
64,VNM,0,1,0,1,2000,238,0
68,GEO,0,0,6,6,2000,47,0
69,CRI,0,0,2,2,2000,9,0
69,PRT,0,0,2,2,2000,64,0
71,ARM,0,0,1,1,2000,26,0
71,BRB,0,0,1,1,2000,28,0
71,CHL,0,0,1,1,2000,58,0
71,ISL,0,0,1,1,2000,29,0
71,IND,0,0,1,1,2000,70,0
71,ISR,0,0,1,1,2000,58,0
71,KWT,0,0,1,1,2000,30,0
71,KGZ,0,0,1,1,2000,71,0
71,MKD,0,0,1,1,2000,15,0
71,QAT,0,0,1,1,2000,19,0
1,USA,36,39,26,101,2004,726,0
2,CHN,32,17,14,63,2004,518,0
3,RUS,28,26,36,90,2004,593,0
4,AUS,17,16,17,50,2004,601,0
5,JPN,16,9,12,37,2004,414,0
6,DEU,13,16,20,49,2004,592,0
7,FRA,11,9,13,33,2004,461,0
8,ITA,10,11,11,32,2004,474,0
9,KOR,9,12,9,30,2004,344,0
10,GBR,9,9,12,30,2004,360,0
11,CUB,9,7,11,27,2004,177,0
12,HUN,8,6,3,17,2004,258,0
13,UKR,8,5,9,22,2004,357,0
14,ROU,8,5,6,19,2004,193,0
15,GRC,6,6,4,16,2004,499,1
16,BRA,5,2,3,10,2004,318,0
17,NOR,5,0,1,6,2004,60,0
18,NLD,4,9,9,22,2004,264,0
19,SWE,4,2,1,7,2004,157,0
20,ESP,3,11,6,20,2004,423,0
21,CAN,3,6,3,12,2004,391,0
22,TUR,3,3,4,10,2004,74,0
23,POL,3,2,5,10,2004,224,0
24,NZL,3,2,0,5,2004,184,0
25,THA,3,1,4,8,2004,51,0
26,BLR,2,5,6,13,2004,192,0
27,AUT,2,4,1,7,2004,92,0
28,ETH,2,3,2,7,2004,27,0
29,IRN,2,2,2,6,2004,37,0
29,SVK,2,2,2,6,2004,84,0
31,TWN,2,2,1,5,2004,104,0
32,GEO,2,2,0,4,2004,39,0
33,BGR,2,1,9,12,2004,119,0
34,DNK,2,1,5,8,2004,115,0
35,JAM,2,1,2,5,2004,62,0
35,UZB,2,1,2,5,2004,79,0
37,MAR,2,1,0,3,2004,57,0
38,ARG,2,0,4,6,2004,179,0
39,CHL,2,0,1,3,2004,29,0
40,KAZ,1,4,3,8,2004,130,0
41,KEN,1,4,2,7,2004,46,0
42,CZE,1,3,5,9,2004,171,0
43,ZAF,1,3,2,6,2004,128,0
44,HRV,1,2,2,5,2004,100,0
45,LTU,1,2,0,3,2004,70,0
46,EGY,1,1,3,5,2004,104,0
46,CHE,1,1,3,5,2004,138,0
48,IDN,1,1,2,4,2004,39,0
49,ZWE,1,1,1,3,2004,14,0
50,AZE,1,0,4,5,2004,37,0
51,BEL,1,0,2,3,2004,70,0
52,BHS,1,0,1,2,2004,28,0
52,ISR,1,0,1,2,2004,46,0
54,CMR,1,0,0,1,2004,19,0
54,DOM,1,0,0,1,2004,33,0
54,ARE,1,0,0,1,2004,5,0
57,PRK,0,4,1,5,2004,71,0
58,LVA,0,4,0,4,2004,45,0
59,MEX,0,3,1,4,2004,137,0
60,PRT,0,2,1,3,2004,93,0
61,FIN,0,2,0,2,2004,67,0
63,SVN,0,1,3,4,2004,102,0
64,EST,0,1,2,3,2004,45,0
65,HKG,0,1,0,1,2004,42,0
65,IND,0,1,0,1,2004,81,0
65,PRY,0,1,0,1,2004,22,0
68,COL,0,0,2,2,2004,71,0
68,NGA,0,0,2,2,2004,79,0
68,VEN,0,0,2,2,2004,53,0
71,ERI,0,0,1,1,2004,5,0
71,MNG,0,0,1,1,2004,21,0
71,SYR,0,0,1,1,2004,6,0
71,TTO,0,0,1,1,2004,26,0
1,CHN,48,22,30,100,2008,730,1
2,USA,36,39,37,112,2008,763,0
3,RUS,24,13,23,60,2008,600,0
4,GBR,19,13,19,51,2008,420,0
5,DEU,16,11,14,41,2008,558,0
6,AUS,14,15,17,46,2008,570,0
7,KOR,13,11,8,32,2008,329,0
8,JPN,9,8,8,25,2008,457,0
9,ITA,8,9,10,27,2008,459,0
10,FRA,7,16,20,43,2008,448,0
11,NLD,7,5,4,16,2008,283,0
12,UKR,7,4,11,22,2008,327,0
13,KEN,6,4,6,16,2008,47,0
14,ESP,5,11,3,19,2008,355,0
15,JAM,5,4,2,11,2008,66,0
16,POL,4,5,2,11,2008,316,0
17,ETH,4,2,1,7,2008,29,0
18,ROU,4,1,4,9,2008,172,0
19,CUB,3,10,17,30,2008,171,0
20,CAN,3,9,8,20,2008,449,0
21,HUN,3,5,2,10,2008,216,0
22,NOR,3,5,1,9,2008,102,0
23,BRA,3,4,10,17,2008,338,0
24,BLR,3,4,7,14,2008,237,0
25,CZE,3,3,1,7,2008,158,0
26,SVK,3,3,0,6,2008,67,0
27,NZL,3,2,4,9,2008,201,0
28,GEO,3,2,2,7,2008,38,0
29,KAZ,2,3,4,9,2008,146,0
30,DNK,2,2,3,7,2008,108,0
31,PRK,2,2,2,6,2008,66,0
31,THA,2,2,2,6,2008,53,0
33,MNG,2,2,0,4,2008,31,0
34,CHE,2,1,4,7,2008,116,0
35,ARG,2,0,4,6,2008,145,0
36,MEX,2,0,2,4,2008,103,0
37,BEL,2,0,0,2,2008,112,0
38,ZWE,1,3,0,4,2008,16,0
39,SVN,1,2,2,5,2008,73,0
40,AZE,1,1,4,6,2008,44,0
40,IDN,1,1,4,6,2008,26,0
42,BGR,1,1,3,5,2008,87,0
42,TUR,1,1,3,5,2008,71,0
44,TWN,1,1,2,4,2008,92,0
44,FIN,1,1,2,4,2008,70,0
46,LVA,1,1,1,3,2008,53,0
47,DOM,1,1,0,2,2008,27,0
47,EST,1,1,0,2,2008,53,0
47,PRT,1,1,0,2,2008,87,0
47,TTO,1,1,0,2,2008,35,0
51,IND,1,0,2,3,2008,67,0
52,IRN,1,0,1,2,2008,55,0
53,CMR,1,0,0,1,2008,32,0
53,PAN,1,0,0,1,2008,5,0
53,TUN,1,0,0,1,2008,29,0
56,SWE,0,4,1,5,2008,169,0
57,LTU,0,3,2,5,2008,78,0
57,NGA,0,3,2,5,2008,89,0
59,HRV,0,2,3,5,2008,125,0
60,COL,0,2,1,3,2008,90,0
60,GRC,0,2,1,3,2008,176,0
62,ARM,0,1,4,5,2008,26,0
63,UZB,0,1,3,4,2008,69,0
64,AUT,0,1,2,3,2008,93,0
64,IRL,0,1,2,3,2008,63,0
64,KGZ,0,1,2,3,2008,22,0
64,SRB,0,1,2,3,2008,97,0
68,DZA,0,1,1,2,2008,57,0
68,BHS,0,1,1,2,2008,33,0
68,MAR,0,1,1,2,2008,49,0
68,TJK,0,1,1,2,2008,16,0
72,CHL,0,1,0,1,2008,29,0
72,ECU,0,1,0,1,2008,26,0
72,ISL,0,1,0,1,2008,31,0
72,MYS,0,1,0,1,2008,42,0
72,WSM,0,1,0,1,2008,7,0
72,SGP,0,1,0,1,2008,36,0
72,ZAF,0,1,0,1,2008,179,0
72,SDN,0,1,0,1,2008,9,0
72,VNM,0,1,0,1,2008,250,0
81,EGY,0,0,2,2,2008,116,0
82,AFG,0,0,1,1,2008,4,0
82,ISR,0,0,1,1,2008,60,0
82,MUS,0,0,1,1,2008,11,0
82,MDA,0,0,1,1,2008,30,0
82,TGO,0,0,1,1,2008,4,0
82,VEN,0,0,1,1,2008,126,0
1,USA,48,26,30,104,2012,689,0
2,CHN,39,31,22,92,2012,479,0
3,GBR,29,18,18,65,2012,684,1
4,RUS,18,21,26,65,2012,549,0
5,KOR,13,9,9,31,2012,312,0
6,DEU,11,20,13,44,2012,510,0
7,FRA,11,11,13,35,2012,426,0
8,AUS,8,15,12,35,2012,514,0
9,ITA,8,9,11,28,2012,382,0
10,HUN,8,4,6,18,2012,201,0
11,JPN,7,14,17,38,2012,399,0
12,IRN,7,5,1,13,2012,57,0
13,NLD,6,6,8,20,2012,222,0
14,NZL,6,2,5,13,2012,204,0
15,UKR,5,4,10,19,2012,304,0
16,CUB,5,3,7,15,2012,118,0
17,ESP,4,10,6,20,2012,339,0
18,JAM,4,5,4,13,2012,62,0
19,CZE,4,4,3,11,2012,159,0
20,ZAF,4,1,1,6,2012,145,0
21,PRK,4,0,2,6,2012,57,0
22,BRA,3,5,9,17,2012,306,0
23,KAZ,3,2,6,11,2012,132,0
23,POL,3,2,6,11,2012,256,0
25,ETH,3,2,3,8,2012,34,0
26,HRV,3,1,2,6,2012,118,0
27,CAN,2,6,10,18,2012,354,0
28,BLR,2,5,3,10,2012,185,0
29,KEN,2,4,7,13,2012,51,0
30,DNK,2,4,3,9,2012,149,0
31,ROU,2,4,1,7,2012,155,0
32,AZE,2,2,5,9,2012,59,0
33,CHE,2,2,0,4,2012,126,0
34,NOR,2,1,1,4,2012,69,0
35,LTU,2,0,3,5,2012,72,0
36,TUN,2,0,1,3,2012,87,0
37,SWE,1,4,3,8,2012,168,0
38,COL,1,3,5,9,2012,120,0
39,MEX,1,3,4,8,2012,119,0
40,GEO,1,2,3,6,2012,36,0
41,IRL,1,1,4,6,2012,76,0
42,ARG,1,1,2,4,2012,148,0
42,SRB,1,1,2,4,2012,134,0
42,SVN,1,1,2,4,2012,78,0
42,TTO,1,1,2,4,2012,38,0
46,TUR,1,1,1,3,2012,119,0
47,DOM,1,1,0,2,2012,36,0
48,TWN,1,0,1,2,2012,55,0
48,LVA,1,0,1,2,2012,50,0
50,DZA,1,0,0,1,2012,39,0
50,BHS,1,0,0,1,2012,29,0
50,BHR,1,0,0,1,2012,14,0
50,GRD,1,0,0,1,2012,8,0
50,UGA,1,0,0,1,2012,16,0
50,VEN,1,0,0,1,2012,85,0
56,EGY,0,3,1,4,2012,132,0
57,IND,0,2,4,6,2012,95,0
58,MNG,0,2,3,5,2012,32,0
59,THA,0,2,2,4,2012,43,0
60,BGR,0,2,1,3,2012,75,0
60,FIN,0,2,1,3,2012,69,0
60,IDN,0,2,1,3,2012,22,0
63,SVK,0,1,3,4,2012,65,0
64,BEL,0,1,2,3,2012,142,0
65,ARM,0,1,1,2,2012,31,0
65,EST,0,1,1,2,2012,36,0
65,MYS,0,1,1,2,2012,38,0
65,PRI,0,1,1,2,2012,28,0
65,QAT,0,1,1,2,2012,14,0
70,BWA,0,1,0,1,2012,4,0
70,CYP,0,1,0,1,2012,13,0
70,GAB,0,1,0,1,2012,21,0
70,GTM,0,1,0,1,2012,24,0
70,MNE,0,1,0,1,2012,34,0
70,PRT,0,1,0,1,2012,98,0
76,UZB,0,0,3,3,2012,56,0
77,GRC,0,0,2,2,2012,115,0
77,SGP,0,0,2,2,2012,36,0
79,AFG,0,0,1,1,2012,6,0
79,CMR,0,0,1,1,2012,32,0
79,HKG,0,0,1,1,2012,55,0
79,KWT,0,0,1,1,2012,12,0
79,MAR,0,0,1,1,2012,67,0
79,SAU,0,0,1,1,2012,23,0
79,TJK,0,0,1,1,2012,16,0
79,VNM,0,0,1,1,2012,17,0
1,USA,46,37,38,121,2016,719,0
2,GBR,27,23,17,67,2016,478,0
3,CHN,26,18,26,70,2016,499,0
4,RUS,19,17,20,56,2016,406,0
5,DEU,17,10,15,42,2016,536,0
6,JPN,12,8,21,41,2016,436,0
7,FRA,10,18,14,42,2016,512,0
8,KOR,9,3,9,21,2016,263,0
9,ITA,8,12,8,28,2016,399,0
10,AUS,8,11,10,29,2016,518,0
11,NLD,8,7,4,19,2016,329,0
12,HUN,8,3,4,15,2016,204,0
13,BRA,7,6,6,19,2016,583,1
14,ESP,7,4,6,17,2016,363,0
15,KEN,6,6,1,13,2016,80,0
16,JAM,6,3,2,11,2016,77,0
17,HRV,5,3,2,10,2016,93,0
18,CUB,5,2,4,11,2016,143,0
19,NZL,4,9,5,18,2016,232,0
20,CAN,4,3,15,22,2016,405,0
21,UZB,4,2,7,13,2016,80,0
22,COL,3,2,3,8,2016,157,0
23,CHE,3,2,2,7,2016,152,0
24,IRN,3,1,4,8,2016,67,0
25,GRC,3,1,2,6,2016,104,0
26,ARG,3,1,0,4,2016,232,0
27,DNK,2,6,7,15,2016,143,0
28,SWE,2,6,3,11,2016,186,0
29,ZAF,2,6,2,10,2016,155,0
30,KAZ,2,5,10,17,2016,123,0
31,UKR,2,5,4,11,2016,272,0
32,SRB,2,4,2,8,2016,127,0
33,POL,2,3,6,11,2016,289,0
34,PRK,2,3,2,7,2016,38,0
35,BEL,2,2,2,6,2016,138,0
35,THA,2,2,2,6,2016,58,0
37,SVK,2,2,0,4,2016,63,0
38,GEO,2,1,4,7,2016,45,0
39,AZE,1,7,10,18,2016,69,0
40,BLR,1,4,4,9,2016,142,0
41,TUR,1,3,4,8,2016,119,0
42,ARM,1,3,0,4,2016,34,0
43,CZE,1,2,7,10,2016,135,0
44,ETH,1,2,5,8,2016,38,0
45,SVN,1,2,1,4,2016,70,0
46,IDN,1,2,0,3,2016,31,0
47,ROU,1,1,2,4,2016,121,0
48,BHR,1,1,0,2,2016,33,0
48,VNM,1,1,0,2,2016,28,0
50,TWN,1,0,2,3,2016,67,0
51,BHS,1,0,1,2,2016,38,0
51,CIV,1,0,1,2,2016,15,0
54,FJI,1,0,0,1,2016,53,0
54,JOR,1,0,0,1,2016,8,0
54,PRI,1,0,0,1,2016,41,0
54,SGP,1,0,0,1,2016,32,0
54,TJK,1,0,0,1,2016,7,0
60,MYS,0,4,1,5,2016,42,0
61,MEX,0,3,2,5,2016,139,0
62,VEN,0,2,1,3,2016,105,0
63,DZA,0,2,0,2,2016,74,0
63,IRL,0,2,0,2,2016,93,0
65,LTU,0,1,3,4,2016,80,0
66,BGR,0,1,2,3,2016,58,0
67,IND,0,1,1,2,2016,130,0
67,MNG,0,1,1,2,2016,46,0
69,BDI,0,1,0,1,2016,10,0
69,GRD,0,1,0,1,2016,6,0
69,NER,0,1,0,1,2016,6,0
69,PHL,0,1,0,1,2016,13,0
69,QAT,0,1,0,1,2016,42,0
74,NOR,0,0,4,4,2016,77,0
75,EGY,0,0,3,3,2016,137,0
75,TUN,0,0,3,3,2016,65,0
77,ISR,0,0,2,2,2016,59,0
78,AUT,0,0,1,1,2016,85,0
78,DOM,0,0,1,1,2016,30,0
78,EST,0,0,1,1,2016,49,0
78,FIN,0,0,1,1,2016,67,0
78,MAR,0,0,1,1,2016,52,0
78,NGA,0,0,1,1,2016,77,0
78,PRT,0,0,1,1,2016,106,0
78,TTO,0,0,1,1,2016,43,0
78,ARE,0,0,1,1,2016,12,0
1,USA,39,41,33,113,2020,856,0
2,CHN,38,32,19,89,2020,574,0
3,JPN,27,14,17,58,2020,787,1
4,GBR,22,20,22,64,2020,548,0
6,AUS,17,7,22,46,2020,638,0
7,NLD,10,12,14,36,2020,391,0
8,FRA,10,12,11,33,2020,538,0
9,DEU,10,11,16,37,2020,597,0
10,ITA,10,10,20,40,2020,524,0
11,CAN,7,7,10,24,2020,509,0
12,BRA,7,6,8,21,2020,416,0
13,NZL,7,6,7,20,2020,279,0
14,CUB,7,3,5,15,2020,82,0
15,HUN,6,7,7,20,2020,237,0
16,KOR,6,4,10,20,2020,338,0
17,POL,4,5,5,14,2020,282,0
18,CZE,4,4,3,11,2020,151,0
19,KEN,4,4,2,10,2020,89,0
20,NOR,4,2,2,8,2020,112,0
21,JAM,4,1,4,9,2020,87,0
22,ESP,3,8,6,17,2020,429,0
23,SWE,3,6,0,9,2020,173,0
24,CHE,3,4,6,13,2020,196,0
25,DNK,3,4,4,11,2020,138,0
26,HRV,3,3,2,8,2020,74,0
27,IRN,3,2,2,7,2020,76,0
28,SRB,3,1,5,9,2020,110,0
29,BEL,3,1,3,7,2020,185,0
30,BGR,3,1,2,6,2020,56,0
31,SVN,3,1,1,5,2020,64,0
32,UZB,3,0,2,5,2020,85,0
33,GEO,2,5,1,8,2020,36,0
34,TWN,2,4,6,12,2020,117,0
35,TUR,2,2,9,13,2020,139,0
36,GRC,2,1,1,4,2020,100,0
36,UGA,2,1,1,4,2020,28,0
38,ECU,2,1,0,3,2020,52,0
39,IRL,2,0,2,4,2020,150,0
39,ISR,2,0,2,4,2020,128,0
41,QAT,2,0,1,3,2020,17,0
42,BHS,2,0,0,2,2020,22,0
44,UKR,1,6,12,19,2020,225,0
45,BLR,1,3,3,7,2020,137,0
46,ROU,1,3,0,4,2020,119,0
46,VEN,1,3,0,4,2020,47,0
48,IND,1,2,4,7,2020,151,0
49,HKG,1,2,3,6,2020,65,0
50,PHL,1,2,1,4,2020,27,0
50,SVK,1,2,1,4,2020,56,0
52,ZAF,1,2,0,3,2020,211,0
53,AUT,1,1,5,7,2020,103,0
54,EGY,1,1,4,6,2020,195,0
55,IDN,1,1,3,5,2020,35,0
56,ETH,1,1,2,4,2020,38,0
56,PRT,1,1,2,4,2020,113,0
58,TUN,1,1,0,2,2020,73,0
59,EST,1,0,1,2,2020,42,0
59,FJI,1,0,1,2,2020,32,0
59,LVA,1,0,1,2,2020,38,0
59,THA,1,0,1,2,2020,48,0
63,BMU,1,0,0,1,2020,2,0
63,MAR,1,0,0,1,2020,51,0
63,PRI,1,0,0,1,2020,39,0
66,COL,0,4,1,5,2020,77,0
67,AZE,0,3,4,7,2020,55,0
68,DOM,0,3,2,5,2020,69,0
69,ARM,0,2,2,4,2020,19,0
70,KGZ,0,2,1,3,2020,17,0
71,MNG,0,1,3,4,2020,61,0
72,ARG,0,1,2,3,2020,208,0
72,SMR,0,1,2,3,2020,8,0
74,JOR,0,1,1,2,2020,15,0
74,MYS,0,1,1,2,2020,47,0
74,NGA,0,1,1,2,2020,68,0
77,BHR,0,1,0,1,2020,33,0
77,LTU,0,1,0,1,2020,59,0
77,NAM,0,1,0,1,2020,11,0
77,MKD,0,1,0,1,2020,8,0
77,SAU,0,1,0,1,2020,33,0
77,TKM,0,1,0,1,2020,10,0
83,KAZ,0,0,8,8,2020,116,0
84,MEX,0,0,4,4,2020,196,0
85,FIN,0,0,2,2,2020,49,0
86,BWA,0,0,1,1,2020,16,0
86,BFA,0,0,1,1,2020,8,0
86,GHA,0,0,1,1,2020,16,0
86,GRD,0,0,1,1,2020,6,0
86,CIV,0,0,1,1,2020,32,0
86,KWT,0,0,1,1,2020,10,0
86,MDA,0,0,1,1,2020,26,0
86,SYR,0,0,1,1,2020,6,0
1,USA,40,44,42,126,2024,854,0
2,CHN,40,27,24,91,2024,587,0
3,JPN,20,12,13,45,2024,598,0
4,AUS,18,19,16,53,2024,649,0
5,FRA,16,26,22,64,2024,801,1
6,NLD,15,7,12,34,2024,449,0
7,GBR,14,22,29,65,2024,533,0
8,KOR,13,9,10,32,2024,248,0
9,ITA,12,13,15,40,2024,610,0
10,DEU,12,13,8,33,2024,647,0
11,NZL,10,7,3,20,2024,253,0
12,CAN,9,7,11,27,2024,538,0
13,UZB,8,2,3,13,2024,119,0
14,HUN,6,7,6,19,2024,255,0
15,ESP,5,4,9,18,2024,526,0
16,SWE,4,4,3,11,2024,173,0
17,KEN,4,2,5,11,2024,77,0
18,NOR,4,1,3,8,2024,128,0
19,IRL,4,0,3,7,2024,185,0
20,BRA,3,7,10,20,2024,401,0
21,IRN,3,6,3,12,2024,46,0
22,UKR,3,5,4,12,2024,212,0
23,ROU,3,4,2,9,2024,144,0
24,GEO,3,3,1,7,2024,38,0
25,BEL,3,1,6,10,2024,240,0
26,BGR,3,1,3,7,2024,61,0
27,SRB,3,1,1,5,2024,135,0
28,CZE,3,0,2,5,2024,149,0
29,DNK,2,2,5,9,2024,161,0
30,AZE,2,2,3,7,2024,49,0
30,HRV,2,2,3,7,2024,85,0
32,CUB,2,1,6,9,2024,69,0
33,BHR,2,1,1,4,2024,15,0
34,SVN,2,1,0,3,2024,117,0
35,TWN,2,0,5,7,2024,78,0
36,AUT,2,0,3,5,2024,121,0
37,HKG,2,0,2,4,2024,51,0
37,PHL,2,0,2,4,2024,44,0
39,DZA,2,0,1,3,2024,55,0
39,IDN,2,0,1,3,2024,36,0
41,ISR,1,5,1,7,2024,138,0
42,POL,1,4,5,10,2024,312,0
43,KAZ,1,3,3,7,2024,123,0
44,JAM,1,3,2,6,2024,81,0
44,ZAF,1,3,2,6,2024,161,0
44,THA,1,3,2,6,2024,58,0
47,ETH,1,3,0,4,2024,35,0
48,CHE,1,2,5,8,2024,218,0
49,ECU,1,2,2,5,2024,47,0
50,PRT,1,2,1,4,2024,95,0
51,GRC,1,1,6,8,2024,126,0
52,ARG,1,1,1,3,2024,154,0
52,EGY,1,1,1,3,2024,207,0
52,TUN,1,1,1,3,2024,31,0
55,BWA,1,1,0,2,2024,19,0
55,CHL,1,1,0,2,2024,52,0
55,LCA,1,1,0,2,2024,5,0
55,UGA,1,1,0,2,2024,27,0
59,DOM,1,0,2,3,2024,64,0
60,GTM,1,0,1,2,2024,16,0
60,MAR,1,0,1,2,2024,63,0
62,DMA,1,0,0,1,2024,4,0
62,PAK,1,0,0,1,2024,10,0
64,TUR,0,3,5,8,2024,165,0
65,MEX,0,3,2,5,2024,155,0
66,ARM,0,3,1,4,2024,17,0
66,COL,0,3,1,4,2024,105,0
68,KGZ,0,2,4,6,2024,17,0
68,PRK,0,2,4,6,2024,18,0
70,LTU,0,2,2,4,2024,63,0
71,IND,0,1,5,6,2024,138,0
72,MDA,0,1,3,4,2024,30,0
74,CYP,0,1,0,1,2024,23,0
74,FJI,0,1,0,1,2024,36,0
74,JOR,0,1,0,1,2024,13,0
74,MNG,0,1,0,1,2024,48,0
74,PAN,0,1,0,1,2024,13,0
79,TJK,0,0,3,3,2024,14,0
80,ALB,0,0,2,2,2024,9,0
80,GRD,0,0,2,2,2024,6,0
80,MYS,0,0,2,2,2024,32,0
80,PRI,0,0,2,2,2024,53,0
84,CPV,0,0,1,1,2024,7,0
84,CIV,0,0,1,1,2024,18,0
84,PER,0,0,1,1,2024,32,0
84,QAT,0,0,1,1,2024,13,0
84,SGP,0,0,1,1,2024,32,0
84,SVK,0,0,1,1,2024,38,0
84,ZMB,0,0,1,1,2024,32,0
